inning,inning_topbot,home_score,away_score,home_team_wins,away_team_wins,games
1,Bot,0,0,1024,1122,2146
1,Bot,0,1,163,323,486
1,Bot,0,2,53,187,240
1,Bot,0,3,21,85,106
1,Bot,0,4,4,39,43
1,Bot,0,5,0,11,11
1,Bot,0,6,0,1,1
1,Bot,0,7,0,3,3
1,Bot,0,10,0,1,1
1,Bot,1,0,268,204,472
1,Bot,1,1,57,55,112
1,Bot,1,2,18,41,59
1,Bot,1,3,8,19,27
1,Bot,1,4,4,13,17
1,Bot,1,5,0,5,5
1,Bot,1,6,0,2,2
1,Bot,1,7,0,2,2
1,Bot,2,0,194,85,279
1,Bot,2,1,44,23,67
1,Bot,2,2,13,16,29
1,Bot,2,3,3,10,13
1,Bot,2,4,4,3,7
1,Bot,2,5,1,1,2
1,Bot,2,6,0,1,1
1,Bot,2,7,0,1,1
1,Bot,3,0,109,24,133
1,Bot,3,1,19,6,25
1,Bot,3,2,7,6,13
1,Bot,3,3,7,3,10
1,Bot,3,4,1,0,1
1,Bot,3,5,0,1,1
1,Bot,3,6,0,1,1
1,Bot,4,0,38,13,51
1,Bot,4,1,12,2,14
1,Bot,4,2,5,0,5
1,Bot,4,3,3,1,4
1,Bot,4,4,0,2,2
1,Bot,5,0,28,3,31
1,Bot,5,1,4,2,6
1,Bot,5,2,1,0,1
1,Bot,5,4,2,0,2
1,Bot,6,0,12,0,12
1,Bot,6,1,2,0,2
1,Bot,6,2,1,0,1
1,Bot,6,3,0,1,1
1,Bot,6,5,1,0,1
1,Bot,6,6,0,1,1
1,Bot,7,0,8,0,8
1,Bot,7,2,2,0,2
1,Bot,8,0,1,0,1
1,Bot,10,0,1,0,1
1,Top,0,0,1686,1453,3139
1,Top,0,1,298,412,710
1,Top,0,2,100,248,348
1,Top,0,3,42,118,160
1,Top,0,4,15,57,72
1,Top,0,5,2,18,20
1,Top,0,6,0,6,6
1,Top,0,7,0,6,6
1,Top,0,10,0,1,1
2,Bot,0,0,547,622,1169
2,Bot,0,1,158,326,484
2,Bot,0,2,54,221,275
2,Bot,0,3,26,136,162
2,Bot,0,4,4,59,63
2,Bot,0,5,2,38,40
2,Bot,0,6,2,17,19
2,Bot,0,7,1,6,7
2,Bot,0,8,0,4,4
2,Bot,0,9,0,1,1
2,Bot,0,10,0,2,2
2,Bot,1,0,304,219,523
2,Bot,1,1,98,105,203
2,Bot,1,2,41,79,120
2,Bot,1,3,15,49,64
2,Bot,1,4,7,30,37
2,Bot,1,5,3,20,23
2,Bot,1,6,1,8,9
2,Bot,1,7,0,5,5
2,Bot,1,8,0,4,4
2,Bot,1,9,0,2,2
2,Bot,1,10,0,1,1
2,Bot,2,0,226,74,300
2,Bot,2,1,91,57,148
2,Bot,2,2,32,39,71
2,Bot,2,3,11,24,35
2,Bot,2,4,4,12,16
2,Bot,2,5,0,8,8
2,Bot,2,6,0,6,6
2,Bot,2,7,0,1,1
2,Bot,2,9,0,1,1
2,Bot,3,0,139,26,165
2,Bot,3,1,43,21,64
2,Bot,3,2,23,15,38
2,Bot,3,3,8,14,22
2,Bot,3,4,3,7,10
2,Bot,3,5,0,2,2
2,Bot,3,6,2,2,4
2,Bot,3,12,0,1,1
2,Bot,4,0,71,15,86
2,Bot,4,1,25,8,33
2,Bot,4,2,19,8,27
2,Bot,4,3,7,2,9
2,Bot,4,4,3,2,5
2,Bot,4,6,1,0,1
2,Bot,4,9,0,1,1
2,Bot,5,0,37,1,38
2,Bot,5,1,17,3,20
2,Bot,5,2,5,3,8
2,Bot,5,3,4,0,4
2,Bot,5,4,1,2,3
2,Bot,5,5,0,1,1
2,Bot,5,6,1,1,2
2,Bot,6,0,37,0,37
2,Bot,6,1,8,2,10
2,Bot,6,2,8,0,8
2,Bot,6,3,1,2,3
2,Bot,6,4,0,0,0
2,Bot,6,6,0,1,1
2,Bot,6,8,0,1,1
2,Bot,7,0,14,1,15
2,Bot,7,1,5,0,5
2,Bot,7,2,4,0,4
2,Bot,7,3,2,0,2
2,Bot,7,4,1,0,1
2,Bot,7,7,1,0,1
2,Bot,8,0,3,0,3
2,Bot,8,1,3,0,3
2,Bot,8,2,3,0,3
2,Bot,8,4,2,0,2
2,Bot,8,6,1,0,1
2,Bot,9,0,6,0,6
2,Bot,9,1,2,0,2
2,Bot,9,5,1,1,2
2,Bot,10,0,1,0,1
2,Bot,10,1,2,0,2
2,Bot,11,0,2,0,2
2,Top,0,0,851,755,1606
2,Top,0,1,247,405,652
2,Top,0,2,103,268,371
2,Top,0,3,43,170,213
2,Top,0,4,8,78,86
2,Top,0,5,2,52,54
2,Top,0,6,3,21,24
2,Top,0,7,1,8,9
2,Top,0,8,0,5,5
2,Top,0,9,0,1,1
2,Top,0,10,0,3,3
2,Top,0,12,0,1,1
2,Top,1,0,216,134,350
2,Top,1,1,83,72,155
2,Top,1,2,35,58,93
2,Top,1,3,13,35,48
2,Top,1,4,8,22,30
2,Top,1,5,2,8,10
2,Top,1,6,1,5,6
2,Top,1,7,0,5,5
2,Top,1,8,0,2,2
2,Top,1,9,0,2,2
2,Top,2,0,158,46,204
2,Top,2,1,68,37,105
2,Top,2,2,25,24,49
2,Top,2,3,6,14,20
2,Top,2,4,3,7,10
2,Top,2,5,0,5,5
2,Top,2,6,1,6,7
2,Top,2,8,0,1,1
2,Top,2,9,0,2,2
2,Top,3,0,92,15,107
2,Top,3,1,28,8,36
2,Top,3,2,12,8,20
2,Top,3,3,8,7,15
2,Top,3,4,2,2,4
2,Top,3,5,0,1,1
2,Top,3,6,1,1,2
2,Top,4,0,32,8,40
2,Top,4,1,14,2,16
2,Top,4,2,8,4,12
2,Top,4,3,2,2,4
2,Top,4,4,3,1,4
2,Top,4,5,1,1,2
2,Top,5,0,22,0,22
2,Top,5,1,8,2,10
2,Top,5,2,2,2,4
2,Top,5,3,1,0,1
2,Top,5,4,1,0,1
2,Top,5,6,1,1,2
2,Top,6,0,9,0,9
2,Top,6,1,3,0,3
2,Top,6,2,2,0,2
2,Top,6,3,1,0,1
2,Top,6,5,0,1,1
2,Top,6,6,1,1,2
2,Top,7,0,6,0,6
2,Top,7,2,2,0,2
2,Top,7,3,1,0,1
2,Top,7,7,1,0,1
2,Top,8,0,1,0,1
2,Top,10,1,1,0,1
3,Bot,0,0,297,343,640
3,Bot,0,1,127,256,383
3,Bot,0,2,49,185,234
3,Bot,0,3,22,145,167
3,Bot,0,4,7,93,100
3,Bot,0,5,1,57,58
3,Bot,0,6,1,31,32
3,Bot,0,7,1,9,10
3,Bot,0,8,0,11,11
3,Bot,0,9,0,3,3
3,Bot,0,10,0,5,5
3,Bot,0,12,0,1,1
3,Bot,1,0,210,170,380
3,Bot,1,1,90,112,202
3,Bot,1,2,42,99,141
3,Bot,1,3,18,79,97
3,Bot,1,4,5,51,56
3,Bot,1,5,2,44,46
3,Bot,1,6,1,16,17
3,Bot,1,7,0,11,11
3,Bot,1,8,0,7,7
3,Bot,1,9,0,4,4
3,Bot,1,10,0,2,2
3,Bot,1,11,0,1,1
3,Bot,2,0,226,65,291
3,Bot,2,1,101,70,171
3,Bot,2,2,46,64,110
3,Bot,2,3,26,47,73
3,Bot,2,4,10,29,39
3,Bot,2,5,2,21,23
3,Bot,2,6,1,15,16
3,Bot,2,7,0,8,8
3,Bot,2,8,0,4,4
3,Bot,2,9,1,0,1
3,Bot,2,10,0,2,2
3,Bot,2,11,0,1,1
3,Bot,3,0,128,20,148
3,Bot,3,1,73,39,112
3,Bot,3,2,39,26,65
3,Bot,3,3,25,26,51
3,Bot,3,4,5,19,24
3,Bot,3,5,3,11,14
3,Bot,3,6,2,7,9
3,Bot,3,7,1,3,4
3,Bot,3,8,0,2,2
3,Bot,3,9,0,2,2
3,Bot,3,14,0,1,1
3,Bot,4,0,96,17,113
3,Bot,4,1,61,13,74
3,Bot,4,2,43,18,61
3,Bot,4,3,16,8,24
3,Bot,4,4,11,7,18
3,Bot,4,5,0,2,2
3,Bot,4,6,2,1,3
3,Bot,4,9,0,2,2
3,Bot,5,0,67,0,67
3,Bot,5,1,35,1,36
3,Bot,5,2,19,6,25
3,Bot,5,3,13,2,15
3,Bot,5,4,6,3,9
3,Bot,5,5,2,3,5
3,Bot,5,6,2,4,6
3,Bot,5,7,1,0,1
3,Bot,6,0,49,2,51
3,Bot,6,1,16,1,17
3,Bot,6,2,12,0,12
3,Bot,6,3,7,2,9
3,Bot,6,4,6,1,7
3,Bot,6,5,0,0,0
3,Bot,6,6,1,0,1
3,Bot,6,8,0,3,3
3,Bot,7,0,19,1,20
3,Bot,7,1,12,0,12
3,Bot,7,2,9,0,9
3,Bot,7,3,4,1,5
3,Bot,7,4,2,0,2
3,Bot,7,5,1,0,1
3,Bot,7,6,0,1,1
3,Bot,7,7,2,0,2
3,Bot,8,0,12,1,13
3,Bot,8,1,6,0,6
3,Bot,8,2,8,0,8
3,Bot,8,3,2,1,3
3,Bot,8,4,1,0,1
3,Bot,8,5,1,0,1
3,Bot,8,6,1,0,1
3,Bot,9,0,6,0,6
3,Bot,9,1,2,0,2
3,Bot,9,2,1,0,1
3,Bot,9,3,1,0,1
3,Bot,9,4,3,0,3
3,Bot,9,5,2,0,2
3,Bot,9,8,0,1,1
3,Bot,10,0,2,0,2
3,Bot,10,1,2,0,2
3,Bot,10,2,5,0,5
3,Bot,10,4,2,0,2
3,Bot,11,0,3,0,3
3,Bot,11,1,1,0,1
3,Bot,11,3,1,0,1
3,Bot,12,1,1,0,1
3,Bot,13,0,4,0,4
3,Top,0,0,445,410,855
3,Top,0,1,205,323,528
3,Top,0,2,74,236,310
3,Top,0,3,50,185,235
3,Top,0,4,11,117,128
3,Top,0,5,2,78,80
3,Top,0,6,2,38,40
3,Top,0,7,2,17,19
3,Top,0,8,0,12,12
3,Top,0,9,0,4,4
3,Top,0,10,0,5,5
3,Top,0,12,0,1,1
3,Top,1,0,249,149,398
3,Top,1,1,111,93,204
3,Top,1,2,55,89,144
3,Top,1,3,28,73,101
3,Top,1,4,14,41,55
3,Top,1,5,5,41,46
3,Top,1,6,2,19,21
3,Top,1,7,2,9,11
3,Top,1,8,0,6,6
3,Top,1,9,0,3,3
3,Top,1,10,0,3,3
3,Top,1,11,0,2,2
3,Top,2,0,184,35,219
3,Top,2,1,98,47,145
3,Top,2,2,51,48,99
3,Top,2,3,22,36,58
3,Top,2,4,12,26,38
3,Top,2,5,1,10,11
3,Top,2,6,1,10,11
3,Top,2,7,0,4,4
3,Top,2,8,0,3,3
3,Top,2,9,0,2,2
3,Top,2,10,0,1,1
3,Top,3,0,112,16,128
3,Top,3,1,44,22,66
3,Top,3,2,38,13,51
3,Top,3,3,13,13,26
3,Top,3,4,4,9,13
3,Top,3,5,3,7,10
3,Top,3,6,3,3,6
3,Top,3,7,0,1,1
3,Top,3,8,0,2,2
3,Top,3,9,0,1,1
3,Top,3,14,0,1,1
3,Top,4,0,55,8,63
3,Top,4,1,30,9,39
3,Top,4,2,22,7,29
3,Top,4,3,8,5,13
3,Top,4,4,10,4,14
3,Top,4,5,0,1,1
3,Top,4,6,1,1,2
3,Top,4,7,1,0,1
3,Top,4,9,0,1,1
3,Top,5,0,26,1,27
3,Top,5,1,21,0,21
3,Top,5,2,8,4,12
3,Top,5,3,7,1,8
3,Top,5,4,3,1,4
3,Top,5,5,0,0,0
3,Top,5,6,1,4,5
3,Top,6,0,31,0,31
3,Top,6,1,9,1,10
3,Top,6,2,7,0,7
3,Top,6,3,4,1,5
3,Top,6,4,1,1,2
3,Top,6,5,1,0,1
3,Top,6,8,0,3,3
3,Top,7,0,12,1,13
3,Top,7,1,5,0,5
3,Top,7,2,7,0,7
3,Top,7,3,2,0,2
3,Top,7,4,1,0,1
3,Top,7,7,1,0,1
3,Top,8,0,3,0,3
3,Top,8,1,2,0,2
3,Top,8,2,2,0,2
3,Top,8,3,1,0,1
3,Top,8,4,1,0,1
3,Top,8,5,1,0,1
3,Top,8,6,1,0,1
3,Top,9,0,3,0,3
3,Top,9,1,2,0,2
3,Top,9,2,2,0,2
3,Top,9,4,1,0,1
3,Top,9,5,1,0,1
3,Top,9,8,0,1,1
3,Top,10,0,1,0,1
3,Top,10,1,2,0,2
3,Top,10,2,1,0,1
3,Top,11,0,2,0,2
4,Bot,0,0,143,188,331
4,Bot,0,1,76,180,256
4,Bot,0,2,34,144,178
4,Bot,0,3,6,127,133
4,Bot,0,4,4,87,91
4,Bot,0,5,2,66,68
4,Bot,0,6,0,40,40
4,Bot,0,7,0,21,21
4,Bot,0,8,0,13,13
4,Bot,0,9,0,4,4
4,Bot,0,10,0,4,4
4,Bot,0,11,0,3,3
4,Bot,0,12,0,2,2
4,Bot,0,13,0,1,1
4,Bot,1,0,150,98,248
4,Bot,1,1,88,120,208
4,Bot,1,2,39,124,163
4,Bot,1,3,19,103,122
4,Bot,1,4,9,81,90
4,Bot,1,5,1,51,52
4,Bot,1,6,0,33,33
4,Bot,1,7,0,10,10
4,Bot,1,8,0,14,14
4,Bot,1,9,1,6,7
4,Bot,1,10,0,2,2
4,Bot,1,11,0,3,3
4,Bot,1,12,0,1,1
4,Bot,1,13,0,1,1
4,Bot,1,14,0,1,1
4,Bot,2,0,171,50,221
4,Bot,2,1,119,67,186
4,Bot,2,2,55,61,116
4,Bot,2,3,24,76,100
4,Bot,2,4,11,56,67
4,Bot,2,5,8,38,46
4,Bot,2,6,0,23,23
4,Bot,2,7,1,15,16
4,Bot,2,8,0,8,8
4,Bot,2,9,0,5,5
4,Bot,2,10,1,2,3
4,Bot,2,11,0,2,2
4,Bot,2,13,0,1,1
4,Bot,2,17,0,1,1
4,Bot,3,0,134,23,157
4,Bot,3,1,103,36,139
4,Bot,3,2,54,39,93
4,Bot,3,3,37,27,64
4,Bot,3,4,8,31,39
4,Bot,3,5,4,14,18
4,Bot,3,6,3,16,19
4,Bot,3,7,1,9,10
4,Bot,3,8,0,1,1
4,Bot,3,9,0,3,3
4,Bot,3,10,0,4,4
4,Bot,3,14,0,1,1
4,Bot,4,0,101,12,113
4,Bot,4,1,73,7,80
4,Bot,4,2,53,26,79
4,Bot,4,3,33,20,53
4,Bot,4,4,12,17,29
4,Bot,4,5,4,9,13
4,Bot,4,6,1,6,7
4,Bot,4,7,0,4,4
4,Bot,4,9,0,3,3
4,Bot,4,12,0,1,1
4,Bot,4,13,0,1,1
4,Bot,5,0,71,3,74
4,Bot,5,1,40,1,41
4,Bot,5,2,36,6,42
4,Bot,5,3,24,7,31
4,Bot,5,4,15,5,20
4,Bot,5,5,5,10,15
4,Bot,5,6,2,5,7
4,Bot,5,7,2,2,4
4,Bot,5,8,0,2,2
4,Bot,5,9,0,1,1
4,Bot,5,10,1,0,1
4,Bot,5,13,0,1,1
4,Bot,6,0,49,2,51
4,Bot,6,1,35,5,40
4,Bot,6,2,27,0,27
4,Bot,6,3,18,1,19
4,Bot,6,4,14,3,17
4,Bot,6,5,1,0,1
4,Bot,6,6,3,2,5
4,Bot,6,7,0,1,1
4,Bot,6,8,0,2,2
4,Bot,6,9,0,1,1
4,Bot,6,14,0,1,1
4,Bot,7,0,29,2,31
4,Bot,7,1,20,1,21
4,Bot,7,2,20,0,20
4,Bot,7,3,7,1,8
4,Bot,7,4,6,0,6
4,Bot,7,5,5,2,7
4,Bot,7,7,0,1,1
4,Bot,7,8,1,1,2
4,Bot,7,9,1,0,1
4,Bot,8,0,17,0,17
4,Bot,8,1,4,0,4
4,Bot,8,2,9,1,10
4,Bot,8,3,4,0,4
4,Bot,8,4,6,1,7
4,Bot,8,5,2,1,3
4,Bot,8,6,2,0,2
4,Bot,8,7,0,0,0
4,Bot,8,9,0,0,0
4,Bot,9,0,13,0,13
4,Bot,9,1,6,0,6
4,Bot,9,2,5,0,5
4,Bot,9,3,0,2,2
4,Bot,9,4,5,1,6
4,Bot,9,6,1,0,1
4,Bot,9,7,1,0,1
4,Bot,9,8,0,1,1
4,Bot,10,0,4,0,4
4,Bot,10,1,7,0,7
4,Bot,10,2,6,0,6
4,Bot,10,3,2,0,2
4,Bot,10,4,6,0,6
4,Bot,10,5,1,0,1
4,Bot,10,6,3,0,3
4,Bot,11,0,5,0,5
4,Bot,11,1,1,0,1
4,Bot,11,2,4,0,4
4,Bot,12,0,1,0,1
4,Bot,12,1,1,0,1
4,Bot,12,2,2,0,2
4,Bot,13,1,4,0,4
4,Bot,15,0,1,0,1
4,Bot,15,4,1,0,1
4,Bot,16,0,1,0,1
4,Bot,17,0,1,0,1
4,Bot,17,1,1,0,1
4,Bot,18,1,1,0,1
4,Top,0,0,242,222,464
4,Top,0,1,145,228,373
4,Top,0,2,67,196,263
4,Top,0,3,31,168,199
4,Top,0,4,11,126,137
4,Top,0,5,4,83,87
4,Top,0,6,1,51,52
4,Top,0,7,0,28,28
4,Top,0,8,0,16,16
4,Top,0,9,1,5,6
4,Top,0,10,0,5,5
4,Top,0,11,0,5,5
4,Top,0,12,0,2,2
4,Top,0,13,0,2,2
4,Top,1,0,176,94,270
4,Top,1,1,99,101,200
4,Top,1,2,55,107,162
4,Top,1,3,24,97,121
4,Top,1,4,10,71,81
4,Top,1,5,4,48,52
4,Top,1,6,2,32,34
4,Top,1,7,0,14,14
4,Top,1,8,0,14,14
4,Top,1,9,0,7,7
4,Top,1,10,0,4,4
4,Top,1,11,0,2,2
4,Top,1,12,0,1,1
4,Top,1,13,0,1,1
4,Top,1,14,0,1,1
4,Top,2,0,176,39,215
4,Top,2,1,125,51,176
4,Top,2,2,58,60,118
4,Top,2,3,31,51,82
4,Top,2,4,15,50,65
4,Top,2,5,6,31,37
4,Top,2,6,1,23,24
4,Top,2,7,1,12,13
4,Top,2,8,0,4,4
4,Top,2,9,0,5,5
4,Top,2,10,1,1,2
4,Top,2,11,0,1,1
4,Top,2,17,0,1,1
4,Top,3,0,95,16,111
4,Top,3,1,78,26,104
4,Top,3,2,50,20,70
4,Top,3,3,31,23,54
4,Top,3,4,11,24,35
4,Top,3,5,5,17,22
4,Top,3,6,2,12,14
4,Top,3,7,1,6,7
4,Top,3,8,0,2,2
4,Top,3,9,0,5,5
4,Top,3,10,0,2,2
4,Top,3,12,0,1,1
4,Top,3,14,0,1,1
4,Top,4,0,79,9,88
4,Top,4,1,59,7,66
4,Top,4,2,45,17,62
4,Top,4,3,28,15,43
4,Top,4,4,13,8,21
4,Top,4,5,4,8,12
4,Top,4,6,2,3,5
4,Top,4,7,1,1,2
4,Top,4,9,0,1,1
4,Top,4,13,0,1,1
4,Top,5,0,58,0,58
4,Top,5,1,29,0,29
4,Top,5,2,21,5,26
4,Top,5,3,18,3,21
4,Top,5,4,13,2,15
4,Top,5,5,3,2,5
4,Top,5,6,1,4,5
4,Top,5,7,1,1,2
4,Top,5,8,0,1,1
4,Top,5,10,1,0,1
4,Top,5,13,0,1,1
4,Top,6,0,40,0,40
4,Top,6,1,20,1,21
4,Top,6,2,14,0,14
4,Top,6,3,5,2,7
4,Top,6,4,9,2,11
4,Top,6,5,2,0,2
4,Top,6,6,1,0,1
4,Top,6,7,0,0,0
4,Top,6,8,0,3,3
4,Top,6,14,0,1,1
4,Top,7,0,13,1,14
4,Top,7,1,8,0,8
4,Top,7,2,16,0,16
4,Top,7,3,3,0,3
4,Top,7,4,5,1,6
4,Top,7,5,2,0,2
4,Top,7,6,1,0,1
4,Top,7,7,0,1,1
4,Top,7,8,1,0,1
4,Top,7,9,1,0,1
4,Top,8,0,8,0,8
4,Top,8,1,4,0,4
4,Top,8,2,9,0,9
4,Top,8,3,3,1,4
4,Top,8,4,2,0,2
4,Top,8,5,2,1,3
4,Top,8,6,3,0,3
4,Top,9,0,3,0,3
4,Top,9,1,2,0,2
4,Top,9,2,2,0,2
4,Top,9,4,5,0,5
4,Top,9,5,1,0,1
4,Top,9,6,1,0,1
4,Top,9,7,1,0,1
4,Top,9,8,0,1,1
4,Top,10,0,1,0,1
4,Top,10,1,3,0,3
4,Top,10,2,5,0,5
4,Top,10,4,2,0,2
4,Top,11,0,2,0,2
4,Top,11,1,2,0,2
4,Top,11,4,1,0,1
4,Top,12,1,1,0,1
4,Top,13,0,2,0,2
4,Top,13,1,2,0,2
5,Bot,0,0,75,109,184
5,Bot,0,1,48,134,182
5,Bot,0,2,22,119,141
5,Bot,0,3,3,96,99
5,Bot,0,4,3,73,76
5,Bot,0,5,1,59,60
5,Bot,0,6,0,46,46
5,Bot,0,7,0,30,30
5,Bot,0,8,0,16,16
5,Bot,0,9,0,7,7
5,Bot,0,10,0,4,4
5,Bot,0,11,0,4,4
5,Bot,0,13,0,1,1
5,Bot,0,14,0,2,2
5,Bot,0,15,0,1,1
5,Bot,1,0,109,63,172
5,Bot,1,1,62,100,162
5,Bot,1,2,33,112,145
5,Bot,1,3,12,107,119
5,Bot,1,4,2,90,92
5,Bot,1,5,4,58,62
5,Bot,1,6,1,42,43
5,Bot,1,7,0,17,17
5,Bot,1,8,0,10,10
5,Bot,1,9,0,9,9
5,Bot,1,10,0,5,5
5,Bot,1,11,0,5,5
5,Bot,1,12,0,1,1
5,Bot,1,13,0,2,2
5,Bot,1,14,0,1,1
5,Bot,1,15,0,1,1
5,Bot,2,0,132,32,164
5,Bot,2,1,95,47,142
5,Bot,2,2,42,65,107
5,Bot,2,3,17,72,89
5,Bot,2,4,13,65,78
5,Bot,2,5,2,46,48
5,Bot,2,6,2,36,38
5,Bot,2,7,0,21,21
5,Bot,2,8,0,23,23
5,Bot,2,9,0,15,15
5,Bot,2,10,1,4,5
5,Bot,2,11,0,4,4
5,Bot,2,12,0,2,2
5,Bot,2,13,0,1,1
5,Bot,3,0,110,16,126
5,Bot,3,1,118,31,149
5,Bot,3,2,58,35,93
5,Bot,3,3,33,35,68
5,Bot,3,4,14,40,54
5,Bot,3,5,4,36,40
5,Bot,3,6,4,27,31
5,Bot,3,7,1,16,17
5,Bot,3,8,0,8,8
5,Bot,3,9,0,10,10
5,Bot,3,10,0,3,3
5,Bot,3,11,0,4,4
5,Bot,3,14,0,2,2
5,Bot,3,19,0,1,1
5,Bot,4,0,95,8,103
5,Bot,4,1,86,15,101
5,Bot,4,2,54,20,74
5,Bot,4,3,39,29,68
5,Bot,4,4,17,34,51
5,Bot,4,5,4,23,27
5,Bot,4,6,2,14,16
5,Bot,4,7,0,8,8
5,Bot,4,8,0,7,7
5,Bot,4,9,0,2,2
5,Bot,4,10,0,2,2
5,Bot,4,12,0,1,1
5,Bot,4,13,0,1,1
5,Bot,4,15,0,2,2
5,Bot,5,0,65,2,67
5,Bot,5,1,66,2,68
5,Bot,5,2,47,9,56
5,Bot,5,3,39,6,45
5,Bot,5,4,24,12,36
5,Bot,5,5,8,13,21
5,Bot,5,6,2,9,11
5,Bot,5,7,2,14,16
5,Bot,5,8,1,2,3
5,Bot,5,9,1,1,2
5,Bot,5,11,0,1,1
5,Bot,6,0,53,0,53
5,Bot,6,1,37,5,42
5,Bot,6,2,45,2,47
5,Bot,6,3,43,6,49
5,Bot,6,4,20,3,23
5,Bot,6,5,10,5,15
5,Bot,6,6,2,4,6
5,Bot,6,7,1,2,3
5,Bot,6,8,1,3,4
5,Bot,6,10,1,1,2
5,Bot,6,16,0,1,1
5,Bot,6,17,0,1,1
5,Bot,7,0,34,1,35
5,Bot,7,1,20,3,23
5,Bot,7,2,20,1,21
5,Bot,7,3,14,0,14
5,Bot,7,4,11,0,11
5,Bot,7,5,5,6,11
5,Bot,7,6,0,1,1
5,Bot,7,7,0,1,1
5,Bot,7,8,2,2,4
5,Bot,7,9,0,2,2
5,Bot,7,10,1,1,2
5,Bot,7,12,0,1,1
5,Bot,8,0,27,0,27
5,Bot,8,1,14,1,15
5,Bot,8,2,23,0,23
5,Bot,8,3,9,0,9
5,Bot,8,4,7,1,8
5,Bot,8,5,5,1,6
5,Bot,8,6,5,0,5
5,Bot,8,7,2,0,2
5,Bot,8,8,1,0,1
5,Bot,8,9,0,0,0
5,Bot,8,10,0,1,1
5,Bot,9,0,23,0,23
5,Bot,9,1,9,0,9
5,Bot,9,2,7,0,7
5,Bot,9,3,6,0,6
5,Bot,9,4,7,1,8
5,Bot,9,5,2,2,4
5,Bot,9,6,2,0,2
5,Bot,9,7,3,0,3
5,Bot,9,8,1,0,1
5,Bot,10,0,6,0,6
5,Bot,10,1,9,0,9
5,Bot,10,2,12,0,12
5,Bot,10,3,8,1,9
5,Bot,10,4,6,0,6
5,Bot,10,5,4,0,4
5,Bot,10,6,5,0,5
5,Bot,10,7,1,0,1
5,Bot,10,8,0,1,1
5,Bot,11,0,6,0,6
5,Bot,11,1,4,0,4
5,Bot,11,2,5,0,5
5,Bot,11,3,3,0,3
5,Bot,11,4,3,0,3
5,Bot,11,5,2,0,2
5,Bot,12,0,1,0,1
5,Bot,12,1,1,0,1
5,Bot,12,2,1,0,1
5,Bot,12,3,2,0,2
5,Bot,12,4,1,0,1
5,Bot,12,6,1,0,1
5,Bot,12,9,1,0,1
5,Bot,13,1,2,0,2
5,Bot,13,3,1,0,1
5,Bot,15,0,1,0,1
5,Bot,15,1,2,0,2
5,Bot,15,3,1,0,1
5,Bot,15,4,2,0,2
5,Bot,17,1,2,0,2
5,Bot,17,7,1,0,1
5,Bot,19,0,1,0,1
5,Bot,19,1,1,0,1
5,Top,0,0,122,124,246
5,Top,0,1,82,155,237
5,Top,0,2,42,140,182
5,Top,0,3,7,124,131
5,Top,0,4,6,104,110
5,Top,0,5,4,82,86
5,Top,0,6,0,60,60
5,Top,0,7,0,38,38
5,Top,0,8,0,21,21
5,Top,0,9,0,11,11
5,Top,0,10,0,6,6
5,Top,0,11,0,8,8
5,Top,0,13,0,1,1
5,Top,0,14,0,2,2
5,Top,0,15,0,2,2
5,Top,1,0,129,55,184
5,Top,1,1,90,98,188
5,Top,1,2,53,116,169
5,Top,1,3,23,107,130
5,Top,1,4,7,96,103
5,Top,1,5,5,61,66
5,Top,1,6,1,48,49
5,Top,1,7,0,26,26
5,Top,1,8,0,16,16
5,Top,1,9,1,13,14
5,Top,1,10,0,5,5
5,Top,1,11,0,3,3
5,Top,1,12,0,2,2
5,Top,1,13,0,2,2
5,Top,1,14,0,1,1
5,Top,1,15,0,1,1
5,Top,2,0,146,33,179
5,Top,2,1,114,48,162
5,Top,2,2,61,62,123
5,Top,2,3,30,70,100
5,Top,2,4,22,61,83
5,Top,2,5,11,42,53
5,Top,2,6,2,31,33
5,Top,2,7,1,16,17
5,Top,2,8,0,19,19
5,Top,2,9,0,11,11
5,Top,2,10,1,4,5
5,Top,2,11,0,4,4
5,Top,2,12,0,1,1
5,Top,2,13,0,1,1
5,Top,2,14,0,1,1
5,Top,2,19,0,1,1
5,Top,3,0,113,11,124
5,Top,3,1,106,26,132
5,Top,3,2,53,26,79
5,Top,3,3,45,28,73
5,Top,3,4,17,29,46
5,Top,3,5,3,31,34
5,Top,3,6,6,23,29
5,Top,3,7,1,11,12
5,Top,3,8,0,7,7
5,Top,3,9,0,6,6
5,Top,3,10,0,3,3
5,Top,3,11,0,2,2
5,Top,3,14,0,1,1
5,Top,4,0,84,6,90
5,Top,4,1,73,6,79
5,Top,4,2,48,15,63
5,Top,4,3,44,17,61
5,Top,4,4,16,21,37
5,Top,4,5,7,15,22
5,Top,4,6,3,10,13
5,Top,4,7,1,5,6
5,Top,4,8,1,2,3
5,Top,4,9,0,2,2
5,Top,4,10,0,3,3
5,Top,4,12,0,1,1
5,Top,4,13,0,1,1
5,Top,4,15,0,1,1
5,Top,5,0,52,1,53
5,Top,5,1,44,1,45
5,Top,5,2,37,3,40
5,Top,5,3,31,3,34
5,Top,5,4,19,5,24
5,Top,5,5,7,11,18
5,Top,5,6,2,5,7
5,Top,5,7,2,11,13
5,Top,5,8,1,1,2
5,Top,5,9,0,1,1
5,Top,5,10,2,0,2
5,Top,5,12,0,1,1
5,Top,5,16,0,1,1
5,Top,6,0,37,0,37
5,Top,6,1,28,4,32
5,Top,6,2,27,2,29
5,Top,6,3,26,1,27
5,Top,6,4,19,1,20
5,Top,6,5,4,2,6
5,Top,6,6,2,2,4
5,Top,6,7,1,0,1
5,Top,6,8,2,3,5
5,Top,6,9,0,2,2
5,Top,6,17,0,1,1
5,Top,7,0,24,1,25
5,Top,7,1,20,2,22
5,Top,7,2,21,0,21
5,Top,7,3,10,0,10
5,Top,7,4,6,0,6
5,Top,7,5,5,2,7
5,Top,7,6,1,1,2
5,Top,7,7,0,1,1
5,Top,7,8,2,1,3
5,Top,7,9,1,0,1
5,Top,8,0,14,0,14
5,Top,8,1,3,0,3
5,Top,8,2,11,0,11
5,Top,8,3,4,0,4
5,Top,8,4,6,0,6
5,Top,8,5,2,2,4
5,Top,8,6,3,0,3
5,Top,8,7,2,0,2
5,Top,8,9,0,0,0
5,Top,8,10,0,1,1
5,Top,9,0,11,0,11
5,Top,9,1,4,0,4
5,Top,9,2,4,0,4
5,Top,9,3,2,1,3
5,Top,9,4,6,1,7
5,Top,9,5,1,1,2
5,Top,9,6,2,0,2
5,Top,9,7,1,0,1
5,Top,9,8,0,1,1
5,Top,10,0,2,0,2
5,Top,10,1,5,0,5
5,Top,10,2,7,0,7
5,Top,10,3,5,0,5
5,Top,10,4,2,0,2
5,Top,10,5,2,0,2
5,Top,10,6,4,0,4
5,Top,10,7,2,0,2
5,Top,11,0,4,0,4
5,Top,11,1,2,0,2
5,Top,11,2,1,0,1
5,Top,11,3,2,0,2
5,Top,11,4,1,0,1
5,Top,12,0,1,0,1
5,Top,12,1,1,0,1
5,Top,12,2,1,0,1
5,Top,12,3,1,0,1
5,Top,13,1,2,0,2
5,Top,13,3,1,0,1
5,Top,13,4,1,0,1
5,Top,15,0,1,0,1
5,Top,15,4,1,0,1
5,Top,16,0,1,0,1
5,Top,17,1,2,0,2
5,Top,18,1,1,0,1
6,Bot,0,0,29,52,81
6,Bot,0,1,19,101,120
6,Bot,0,2,13,89,102
6,Bot,0,3,0,65,65
6,Bot,0,4,1,67,68
6,Bot,0,5,1,51,52
6,Bot,0,6,0,38,38
6,Bot,0,7,0,33,33
6,Bot,0,8,0,11,11
6,Bot,0,9,0,11,11
6,Bot,0,10,0,8,8
6,Bot,0,11,0,7,7
6,Bot,0,14,0,2,2
6,Bot,0,15,0,1,1
6,Bot,1,0,86,35,121
6,Bot,1,1,36,83,119
6,Bot,1,2,18,108,126
6,Bot,1,3,7,96,103
6,Bot,1,4,2,91,93
6,Bot,1,5,5,52,57
6,Bot,1,6,0,49,49
6,Bot,1,7,0,24,24
6,Bot,1,8,0,19,19
6,Bot,1,9,0,14,14
6,Bot,1,10,0,8,8
6,Bot,1,11,0,6,6
6,Bot,1,13,0,1,1
6,Bot,1,14,0,2,2
6,Bot,1,15,0,3,3
6,Bot,1,16,0,1,1
6,Bot,2,0,89,21,110
6,Bot,2,1,86,40,126
6,Bot,2,2,35,57,92
6,Bot,2,3,19,84,103
6,Bot,2,4,5,72,77
6,Bot,2,5,2,58,60
6,Bot,2,6,0,46,46
6,Bot,2,7,0,32,32
6,Bot,2,8,0,26,26
6,Bot,2,9,0,10,10
6,Bot,2,10,0,6,6
6,Bot,2,11,0,8,8
6,Bot,2,12,0,2,2
6,Bot,2,14,0,1,1
6,Bot,3,0,92,9,101
6,Bot,3,1,103,17,120
6,Bot,3,2,60,32,92
6,Bot,3,3,25,55,80
6,Bot,3,4,10,40,50
6,Bot,3,5,3,58,61
6,Bot,3,6,3,38,41
6,Bot,3,7,2,24,26
6,Bot,3,8,0,20,20
6,Bot,3,9,0,17,17
6,Bot,3,10,1,5,6
6,Bot,3,11,0,6,6
6,Bot,3,12,0,4,4
6,Bot,3,13,0,1,1
6,Bot,3,15,0,1,1
6,Bot,4,0,77,5,82
6,Bot,4,1,98,5,103
6,Bot,4,2,77,17,94
6,Bot,4,3,46,25,71
6,Bot,4,4,16,40,56
6,Bot,4,5,4,31,35
6,Bot,4,6,3,37,40
6,Bot,4,7,1,15,16
6,Bot,4,8,2,14,16
6,Bot,4,9,0,9,9
6,Bot,4,10,0,6,6
6,Bot,4,11,0,3,3
6,Bot,4,12,0,4,4
6,Bot,4,13,0,2,2
6,Bot,4,15,0,1,1
6,Bot,4,17,0,2,2
6,Bot,5,0,48,0,48
6,Bot,5,1,73,2,75
6,Bot,5,2,63,8,71
6,Bot,5,3,51,10,61
6,Bot,5,4,35,15,50
6,Bot,5,5,10,18,28
6,Bot,5,6,4,15,19
6,Bot,5,7,1,13,14
6,Bot,5,8,0,8,8
6,Bot,5,9,0,3,3
6,Bot,5,10,0,2,2
6,Bot,5,11,0,1,1
6,Bot,5,12,0,1,1
6,Bot,5,14,0,1,1
6,Bot,5,20,0,1,1
6,Bot,6,0,45,0,45
6,Bot,6,1,46,1,47
6,Bot,6,2,54,3,57
6,Bot,6,3,41,4,45
6,Bot,6,4,30,3,33
6,Bot,6,5,13,9,22
6,Bot,6,6,4,7,11
6,Bot,6,7,0,11,11
6,Bot,6,8,2,1,3
6,Bot,6,9,0,2,2
6,Bot,6,10,0,4,4
6,Bot,6,16,0,1,1
6,Bot,7,0,28,0,28
6,Bot,7,1,28,2,30
6,Bot,7,2,37,1,38
6,Bot,7,3,26,1,27
6,Bot,7,4,19,0,19
6,Bot,7,5,13,2,15
6,Bot,7,6,1,5,6
6,Bot,7,7,1,1,2
6,Bot,7,8,2,2,4
6,Bot,7,9,0,5,5
6,Bot,7,10,0,2,2
6,Bot,7,17,0,1,1
6,Bot,8,0,30,0,30
6,Bot,8,1,22,0,22
6,Bot,8,2,26,0,26
6,Bot,8,3,24,0,24
6,Bot,8,4,8,1,9
6,Bot,8,5,9,2,11
6,Bot,8,6,4,0,4
6,Bot,8,7,2,1,3
6,Bot,8,8,1,0,1
6,Bot,8,10,0,2,2
6,Bot,9,0,20,0,20
6,Bot,9,1,20,0,20
6,Bot,9,2,13,0,13
6,Bot,9,3,8,1,9
6,Bot,9,4,8,1,9
6,Bot,9,5,5,1,6
6,Bot,9,6,5,0,5
6,Bot,9,7,4,0,4
6,Bot,9,8,1,2,3
6,Bot,9,9,1,0,1
6,Bot,9,10,1,1,2
6,Bot,9,12,0,1,1
6,Bot,10,0,10,0,10
6,Bot,10,1,8,0,8
6,Bot,10,2,14,1,15
6,Bot,10,3,9,0,9
6,Bot,10,4,13,0,13
6,Bot,10,5,8,0,8
6,Bot,10,6,4,1,5
6,Bot,10,7,2,1,3
6,Bot,10,8,3,1,4
6,Bot,10,9,3,0,3
6,Bot,10,11,0,1,1
6,Bot,11,0,7,0,7
6,Bot,11,1,5,0,5
6,Bot,11,2,13,0,13
6,Bot,11,3,7,0,7
6,Bot,11,4,4,0,4
6,Bot,11,5,3,0,3
6,Bot,11,6,3,0,3
6,Bot,11,7,3,0,3
6,Bot,11,8,2,0,2
6,Bot,11,10,1,0,1
6,Bot,12,0,6,0,6
6,Bot,12,1,1,0,1
6,Bot,12,2,4,0,4
6,Bot,12,3,5,0,5
6,Bot,12,4,3,0,3
6,Bot,12,5,1,0,1
6,Bot,12,6,1,0,1
6,Bot,13,0,1,0,1
6,Bot,13,1,2,0,2
6,Bot,13,2,1,0,1
6,Bot,13,3,1,0,1
6,Bot,13,4,1,0,1
6,Bot,13,5,1,0,1
6,Bot,13,6,1,0,1
6,Bot,13,8,0,1,1
6,Bot,14,0,1,0,1
6,Bot,14,1,2,0,2
6,Bot,14,2,1,0,1
6,Bot,14,3,1,0,1
6,Bot,14,5,1,0,1
6,Bot,14,6,1,0,1
6,Bot,15,0,1,0,1
6,Bot,15,3,1,0,1
6,Bot,15,4,1,0,1
6,Bot,15,5,1,0,1
6,Bot,15,7,1,0,1
6,Bot,15,9,1,0,1
6,Bot,16,1,1,0,1
6,Bot,16,3,1,0,1
6,Bot,16,4,2,0,2
6,Bot,17,1,2,0,2
6,Bot,17,2,1,0,1
6,Bot,17,4,1,0,1
6,Bot,17,7,1,0,1
6,Bot,18,2,1,0,1
6,Bot,19,0,1,0,1
6,Bot,19,1,1,0,1
6,Bot,19,2,1,0,1
6,Top,0,0,64,63,127
6,Top,0,1,47,116,163
6,Top,0,2,29,121,150
6,Top,0,3,7,91,98
6,Top,0,4,3,88,91
6,Top,0,5,1,65,66
6,Top,0,6,0,54,54
6,Top,0,7,0,42,42
6,Top,0,8,0,16,16
6,Top,0,9,0,16,16
6,Top,0,10,0,9,9
6,Top,0,11,0,11,11
6,Top,0,12,0,1,1
6,Top,0,14,0,2,2
6,Top,0,15,0,1,1
6,Top,0,16,0,1,1
6,Top,1,0,91,30,121
6,Top,1,1,66,80,146
6,Top,1,2,40,99,139
6,Top,1,3,14,108,122
6,Top,1,4,5,96,101
6,Top,1,5,6,72,78
6,Top,1,6,1,56,57
6,Top,1,7,0,25,25
6,Top,1,8,0,20,20
6,Top,1,9,0,13,13
6,Top,1,10,0,13,13
6,Top,1,11,0,6,6
6,Top,1,13,0,1,1
6,Top,1,14,0,3,3
6,Top,1,15,0,3,3
6,Top,2,0,112,18,130
6,Top,2,1,91,33,124
6,Top,2,2,51,46,97
6,Top,2,3,24,71,95
6,Top,2,4,14,71,85
6,Top,2,5,5,51,56
6,Top,2,6,1,42,43
6,Top,2,7,1,31,32
6,Top,2,8,0,33,33
6,Top,2,9,0,19,19
6,Top,2,10,1,5,6
6,Top,2,11,0,7,7
6,Top,2,12,0,3,3
6,Top,2,13,0,2,2
6,Top,2,14,0,1,1
6,Top,3,0,85,6,91
6,Top,3,1,113,15,128
6,Top,3,2,76,26,102
6,Top,3,3,37,38,75
6,Top,3,4,17,32,49
6,Top,3,5,7,49,56
6,Top,3,6,4,33,37
6,Top,3,7,1,24,25
6,Top,3,8,1,17,18
6,Top,3,9,0,8,8
6,Top,3,10,0,6,6
6,Top,3,11,0,6,6
6,Top,3,12,0,3,3
6,Top,3,15,0,1,1
6,Top,3,17,0,1,1
6,Top,3,20,0,1,1
6,Top,4,0,70,5,75
6,Top,4,1,80,4,84
6,Top,4,2,66,15,81
6,Top,4,3,52,22,74
6,Top,4,4,23,28,51
6,Top,4,5,5,25,30
6,Top,4,6,3,29,32
6,Top,4,7,1,14,15
6,Top,4,8,0,6,6
6,Top,4,9,0,7,7
6,Top,4,10,0,3,3
6,Top,4,11,0,1,1
6,Top,4,12,0,3,3
6,Top,4,13,0,1,1
6,Top,4,15,0,1,1
6,Top,4,17,0,1,1
6,Top,5,0,41,0,41
6,Top,5,1,65,2,67
6,Top,5,2,52,7,59
6,Top,5,3,47,6,53
6,Top,5,4,28,9,37
6,Top,5,5,13,12,25
6,Top,5,6,4,14,18
6,Top,5,7,3,11,14
6,Top,5,8,1,7,8
6,Top,5,9,1,3,4
6,Top,5,12,0,1,1
6,Top,6,0,41,0,41
6,Top,6,1,33,1,34
6,Top,6,2,45,2,47
6,Top,6,3,41,5,46
6,Top,6,4,29,2,31
6,Top,6,5,13,5,18
6,Top,6,6,5,5,10
6,Top,6,7,1,5,6
6,Top,6,8,2,1,3
6,Top,6,9,0,2,2
6,Top,6,10,1,3,4
6,Top,6,16,0,1,1
6,Top,6,17,0,1,1
6,Top,7,0,17,0,17
6,Top,7,1,23,2,25
6,Top,7,2,26,1,27
6,Top,7,3,15,0,15
6,Top,7,4,12,0,12
6,Top,7,5,8,2,10
6,Top,7,6,3,3,6
6,Top,7,7,0,1,1
6,Top,7,8,2,2,4
6,Top,7,9,1,3,4
6,Top,7,10,1,4,5
6,Top,7,12,0,1,1
6,Top,8,0,22,0,22
6,Top,8,1,12,0,12
6,Top,8,2,17,0,17
6,Top,8,3,14,0,14
6,Top,8,4,12,2,14
6,Top,8,5,6,0,6
6,Top,8,6,4,0,4
6,Top,8,7,5,0,5
6,Top,8,8,2,0,2
6,Top,8,10,0,1,1
6,Top,8,11,0,1,1
6,Top,9,0,18,0,18
6,Top,9,1,11,0,11
6,Top,9,2,9,0,9
6,Top,9,3,6,0,6
6,Top,9,4,4,0,4
6,Top,9,5,5,1,6
6,Top,9,6,3,0,3
6,Top,9,7,2,0,2
6,Top,9,8,2,2,4
6,Top,9,9,1,0,1
6,Top,10,0,5,0,5
6,Top,10,1,5,0,5
6,Top,10,2,9,0,9
6,Top,10,3,9,0,9
6,Top,10,4,6,0,6
6,Top,10,5,6,0,6
6,Top,10,6,5,0,5
6,Top,10,7,2,1,3
6,Top,10,8,2,1,3
6,Top,10,9,1,0,1
6,Top,11,0,4,0,4
6,Top,11,1,2,0,2
6,Top,11,2,8,0,8
6,Top,11,3,3,0,3
6,Top,11,4,3,0,3
6,Top,11,5,2,0,2
6,Top,11,6,1,0,1
6,Top,11,7,1,0,1
6,Top,12,2,2,0,2
6,Top,12,3,2,0,2
6,Top,12,4,1,0,1
6,Top,12,5,1,0,1
6,Top,12,6,1,0,1
6,Top,12,9,1,0,1
6,Top,13,1,2,0,2
6,Top,13,5,1,0,1
6,Top,15,0,1,0,1
6,Top,15,1,2,0,2
6,Top,15,3,1,0,1
6,Top,15,4,2,0,2
6,Top,17,1,1,0,1
6,Top,17,2,1,0,1
6,Top,17,7,1,0,1
6,Top,19,0,1,0,1
6,Top,19,2,1,0,1
7,Bot,0,0,4,22,26
7,Bot,0,1,6,79,85
7,Bot,0,2,3,72,75
7,Bot,0,3,0,50,50
7,Bot,0,4,0,60,60
7,Bot,0,5,0,40,40
7,Bot,0,6,0,25,25
7,Bot,0,7,0,33,33
7,Bot,0,8,0,17,17
7,Bot,0,9,0,9,9
7,Bot,0,10,0,5,5
7,Bot,0,11,0,5,5
7,Bot,0,12,0,1,1
7,Bot,0,13,0,2,2
7,Bot,0,14,0,2,2
7,Bot,0,15,0,1,1
7,Bot,1,0,53,15,68
7,Bot,1,1,17,68,85
7,Bot,1,2,9,94,103
7,Bot,1,3,2,84,86
7,Bot,1,4,0,82,82
7,Bot,1,5,0,57,57
7,Bot,1,6,0,58,58
7,Bot,1,7,0,23,23
7,Bot,1,8,0,21,21
7,Bot,1,9,0,13,13
7,Bot,1,10,0,11,11
7,Bot,1,11,0,8,8
7,Bot,1,13,0,3,3
7,Bot,1,15,0,2,2
7,Bot,2,0,75,11,86
7,Bot,2,1,70,25,95
7,Bot,2,2,25,52,77
7,Bot,2,3,8,81,89
7,Bot,2,4,4,83,87
7,Bot,2,5,0,58,58
7,Bot,2,6,0,55,55
7,Bot,2,7,1,25,26
7,Bot,2,8,0,31,31
7,Bot,2,9,0,16,16
7,Bot,2,10,0,14,14
7,Bot,2,11,0,9,9
7,Bot,2,12,0,5,5
7,Bot,2,14,0,2,2
7,Bot,2,16,0,2,2
7,Bot,2,18,0,1,1
7,Bot,2,20,0,1,1
7,Bot,3,0,66,5,71
7,Bot,3,1,91,10,101
7,Bot,3,2,70,19,89
7,Bot,3,3,14,54,68
7,Bot,3,4,4,50,54
7,Bot,3,5,5,69,74
7,Bot,3,6,0,51,51
7,Bot,3,7,0,29,29
7,Bot,3,8,0,36,36
7,Bot,3,9,0,18,18
7,Bot,3,10,0,14,14
7,Bot,3,11,0,7,7
7,Bot,3,13,0,2,2
7,Bot,3,14,0,1,1
7,Bot,3,16,0,1,1
7,Bot,4,0,73,2,75
7,Bot,4,1,94,1,95
7,Bot,4,2,72,18,90
7,Bot,4,3,54,25,79
7,Bot,4,4,12,34,46
7,Bot,4,5,0,51,51
7,Bot,4,6,2,44,46
7,Bot,4,7,2,21,23
7,Bot,4,8,0,17,17
7,Bot,4,9,0,14,14
7,Bot,4,10,0,7,7
7,Bot,4,11,0,7,7
7,Bot,4,12,0,9,9
7,Bot,4,13,0,2,2
7,Bot,4,14,0,3,3
7,Bot,4,16,0,1,1
7,Bot,4,17,0,2,2
7,Bot,4,18,0,1,1
7,Bot,5,0,54,0,54
7,Bot,5,1,64,2,66
7,Bot,5,2,75,2,77
7,Bot,5,3,53,2,55
7,Bot,5,4,40,15,55
7,Bot,5,5,6,22,28
7,Bot,5,6,6,25,31
7,Bot,5,7,1,26,27
7,Bot,5,8,0,23,23
7,Bot,5,9,0,11,11
7,Bot,5,10,1,7,8
7,Bot,5,11,0,3,3
7,Bot,5,12,0,2,2
7,Bot,5,13,0,1,1
7,Bot,5,14,0,1,1
7,Bot,5,20,0,1,1
7,Bot,6,0,40,0,40
7,Bot,6,1,51,1,52
7,Bot,6,2,51,1,52
7,Bot,6,3,45,4,49
7,Bot,6,4,42,2,44
7,Bot,6,5,25,5,30
7,Bot,6,6,3,9,12
7,Bot,6,7,1,9,10
7,Bot,6,8,0,7,7
7,Bot,6,9,0,6,6
7,Bot,6,10,0,4,4
7,Bot,6,11,0,2,2
7,Bot,6,12,0,1,1
7,Bot,6,13,0,1,1
7,Bot,6,14,0,1,1
7,Bot,6,15,0,1,1
7,Bot,6,16,0,1,1
7,Bot,7,0,24,0,24
7,Bot,7,1,32,1,33
7,Bot,7,2,44,0,44
7,Bot,7,3,35,2,37
7,Bot,7,4,28,0,28
7,Bot,7,5,27,4,31
7,Bot,7,6,6,2,8
7,Bot,7,7,0,3,3
7,Bot,7,8,0,8,8
7,Bot,7,9,0,7,7
7,Bot,7,10,0,2,2
7,Bot,7,11,0,1,1
7,Bot,7,12,0,2,2
7,Bot,8,0,23,0,23
7,Bot,8,1,26,0,26
7,Bot,8,2,28,0,28
7,Bot,8,3,30,0,30
7,Bot,8,4,17,0,17
7,Bot,8,5,11,2,13
7,Bot,8,6,10,0,10
7,Bot,8,7,5,2,7
7,Bot,8,8,1,2,3
7,Bot,8,9,0,2,2
7,Bot,8,10,0,0,0
7,Bot,8,11,0,2,2
7,Bot,8,12,0,1,1
7,Bot,9,0,18,0,18
7,Bot,9,1,21,0,21
7,Bot,9,2,21,0,21
7,Bot,9,3,13,0,13
7,Bot,9,4,18,0,18
7,Bot,9,5,12,1,13
7,Bot,9,6,9,1,10
7,Bot,9,7,2,0,2
7,Bot,9,8,5,1,6
7,Bot,9,10,0,3,3
7,Bot,9,15,0,1,1
7,Bot,10,0,22,0,22
7,Bot,10,1,16,0,16
7,Bot,10,2,17,0,17
7,Bot,10,3,19,0,19
7,Bot,10,4,8,0,8
7,Bot,10,5,9,1,10
7,Bot,10,6,6,0,6
7,Bot,10,7,5,0,5
7,Bot,10,8,4,1,5
7,Bot,10,9,2,0,2
7,Bot,10,10,0,1,1
7,Bot,10,11,1,0,1
7,Bot,10,12,0,1,1
7,Bot,10,14,0,1,1
7,Bot,11,0,3,0,3
7,Bot,11,1,9,0,9
7,Bot,11,2,14,0,14
7,Bot,11,3,9,0,9
7,Bot,11,4,12,1,13
7,Bot,11,5,9,0,9
7,Bot,11,6,7,0,7
7,Bot,11,7,4,1,5
7,Bot,11,8,1,1,2
7,Bot,11,9,1,0,1
7,Bot,11,10,1,0,1
7,Bot,11,11,0,0,0
7,Bot,12,0,1,0,1
7,Bot,12,1,3,0,3
7,Bot,12,2,7,0,7
7,Bot,12,3,6,0,6
7,Bot,12,4,7,0,7
7,Bot,12,5,2,0,2
7,Bot,12,6,3,0,3
7,Bot,12,7,1,0,1
7,Bot,12,9,1,0,1
7,Bot,13,0,4,0,4
7,Bot,13,2,3,0,3
7,Bot,13,3,3,0,3
7,Bot,13,5,3,0,3
7,Bot,13,6,1,0,1
7,Bot,13,7,2,0,2
7,Bot,13,8,1,0,1
7,Bot,13,10,0,1,1
7,Bot,13,17,0,1,1
7,Bot,14,0,3,0,3
7,Bot,14,1,3,0,3
7,Bot,14,2,4,0,4
7,Bot,14,3,1,0,1
7,Bot,14,4,1,0,1
7,Bot,14,5,1,0,1
7,Bot,14,6,2,0,2
7,Bot,14,8,1,0,1
7,Bot,14,9,2,0,2
7,Bot,14,10,1,0,1
7,Bot,15,0,2,0,2
7,Bot,15,1,2,0,2
7,Bot,15,3,2,0,2
7,Bot,15,4,1,0,1
7,Bot,15,5,1,0,1
7,Bot,15,6,1,0,1
7,Bot,15,8,1,0,1
7,Bot,15,9,1,0,1
7,Bot,16,2,1,0,1
7,Bot,16,3,1,0,1
7,Bot,16,4,1,0,1
7,Bot,16,5,1,0,1
7,Bot,16,6,1,0,1
7,Bot,17,0,1,0,1
7,Bot,17,1,1,0,1
7,Bot,17,3,1,0,1
7,Bot,17,5,1,0,1
7,Bot,17,6,1,0,1
7,Bot,17,7,1,0,1
7,Bot,18,4,1,0,1
7,Bot,19,1,1,0,1
7,Bot,19,2,2,0,2
7,Bot,19,5,1,0,1
7,Bot,20,1,1,0,1
7,Bot,21,1,1,0,1
7,Bot,21,2,1,0,1
7,Bot,21,5,1,0,1
7,Top,0,0,28,24,52
7,Top,0,1,20,89,109
7,Top,0,2,13,85,98
7,Top,0,3,0,66,66
7,Top,0,4,1,73,74
7,Top,0,5,1,61,62
7,Top,0,6,0,41,41
7,Top,0,7,0,35,35
7,Top,0,8,0,20,20
7,Top,0,9,0,14,14
7,Top,0,10,0,8,8
7,Top,0,11,0,8,8
7,Top,0,12,0,1,1
7,Top,0,13,0,3,3
7,Top,0,14,0,3,3
7,Top,0,15,0,1,1
7,Top,1,0,74,14,88
7,Top,1,1,39,65,104
7,Top,1,2,22,95,117
7,Top,1,3,9,91,100
7,Top,1,4,3,95,98
7,Top,1,5,3,62,65
7,Top,1,6,3,64,67
7,Top,1,7,0,30,30
7,Top,1,8,0,29,29
7,Top,1,9,0,18,18
7,Top,1,10,0,13,13
7,Top,1,11,0,8,8
7,Top,1,12,0,3,3
7,Top,1,13,0,2,2
7,Top,1,14,0,1,1
7,Top,1,15,0,2,2
7,Top,1,16,0,2,2
7,Top,1,20,0,1,1
7,Top,2,0,76,11,87
7,Top,2,1,85,25,110
7,Top,2,2,45,45,90
7,Top,2,3,19,76,95
7,Top,2,4,10,73,83
7,Top,2,5,1,60,61
7,Top,2,6,0,57,57
7,Top,2,7,1,29,30
7,Top,2,8,0,39,39
7,Top,2,9,0,15,15
7,Top,2,10,0,13,13
7,Top,2,11,0,7,7
7,Top,2,12,0,7,7
7,Top,2,13,0,1,1
7,Top,2,14,0,1,1
7,Top,2,16,0,1,1
7,Top,2,18,0,1,1
7,Top,3,0,71,4,75
7,Top,3,1,96,7,103
7,Top,3,2,77,20,97
7,Top,3,3,25,43,68
7,Top,3,4,14,45,59
7,Top,3,5,9,61,70
7,Top,3,6,3,46,49
7,Top,3,7,2,32,34
7,Top,3,8,0,29,29
7,Top,3,9,0,14,14
7,Top,3,10,1,12,13
7,Top,3,11,0,9,9
7,Top,3,12,0,1,1
7,Top,3,13,0,2,2
7,Top,3,14,0,2,2
7,Top,3,16,0,1,1
7,Top,4,0,64,2,66
7,Top,4,1,91,1,92
7,Top,4,2,71,12,83
7,Top,4,3,61,20,81
7,Top,4,4,24,31,55
7,Top,4,5,5,35,40
7,Top,4,6,4,38,42
7,Top,4,7,1,18,19
7,Top,4,8,2,18,20
7,Top,4,9,0,14,14
7,Top,4,10,0,10,10
7,Top,4,11,0,5,5
7,Top,4,12,0,5,5
7,Top,4,13,0,2,2
7,Top,4,14,0,1,1
7,Top,4,17,0,2,2
7,Top,4,18,0,1,1
7,Top,5,0,41,0,41
7,Top,5,1,57,1,58
7,Top,5,2,62,1,63
7,Top,5,3,60,2,62
7,Top,5,4,40,10,50
7,Top,5,5,16,18,34
7,Top,5,6,8,14,22
7,Top,5,7,2,18,20
7,Top,5,8,0,16,16
7,Top,5,9,0,7,7
7,Top,5,10,0,4,4
7,Top,5,11,0,2,2
7,Top,5,12,0,2,2
7,Top,5,13,0,1,1
7,Top,5,14,0,1,1
7,Top,5,15,0,1,1
7,Top,5,20,0,1,1
7,Top,6,0,32,0,32
7,Top,6,1,39,0,39
7,Top,6,2,53,1,54
7,Top,6,3,40,3,43
7,Top,6,4,37,1,38
7,Top,6,5,25,5,30
7,Top,6,6,6,6,12
7,Top,6,7,0,8,8
7,Top,6,8,2,8,10
7,Top,6,9,0,6,6
7,Top,6,10,0,5,5
7,Top,6,11,0,2,2
7,Top,6,14,0,1,1
7,Top,6,16,0,1,1
7,Top,7,0,18,0,18
7,Top,7,1,30,1,31
7,Top,7,2,31,0,31
7,Top,7,3,27,1,28
7,Top,7,4,23,0,23
7,Top,7,5,16,3,19
7,Top,7,6,7,2,9
7,Top,7,7,1,2,3
7,Top,7,8,1,4,5
7,Top,7,9,1,6,7
7,Top,7,10,0,1,1
7,Top,7,12,0,1,1
7,Top,7,17,0,1,1
7,Top,8,0,26,0,26
7,Top,8,1,16,0,16
7,Top,8,2,27,0,27
7,Top,8,3,21,0,21
7,Top,8,4,14,0,14
7,Top,8,5,11,0,11
7,Top,8,6,7,0,7
7,Top,8,7,4,1,5
7,Top,8,8,1,1,2
7,Top,8,9,0,1,1
7,Top,8,10,0,0,0
7,Top,8,11,0,2,2
7,Top,8,12,0,1,1
7,Top,9,0,16,0,16
7,Top,9,1,16,0,16
7,Top,9,2,14,0,14
7,Top,9,3,11,0,11
7,Top,9,4,10,1,11
7,Top,9,5,7,1,8
7,Top,9,6,5,1,6
7,Top,9,7,3,0,3
7,Top,9,8,2,1,3
7,Top,9,9,1,0,1
7,Top,9,10,1,1,2
7,Top,9,12,0,1,1
7,Top,9,15,0,1,1
7,Top,10,0,9,0,9
7,Top,10,1,8,0,8
7,Top,10,2,11,0,11
7,Top,10,3,9,0,9
7,Top,10,4,10,0,10
7,Top,10,5,9,1,10
7,Top,10,6,7,0,7
7,Top,10,7,5,1,6
7,Top,10,8,3,1,4
7,Top,10,9,3,0,3
7,Top,10,10,0,1,1
7,Top,10,11,1,0,1
7,Top,10,14,0,1,1
7,Top,11,0,6,0,6
7,Top,11,1,5,0,5
7,Top,11,2,12,0,12
7,Top,11,3,5,0,5
7,Top,11,4,4,0,4
7,Top,11,5,5,0,5
7,Top,11,6,4,0,4
7,Top,11,7,3,0,3
7,Top,11,8,2,0,2
7,Top,11,9,1,0,1
7,Top,11,10,1,0,1
7,Top,12,0,3,0,3
7,Top,12,1,1,0,1
7,Top,12,2,5,0,5
7,Top,12,3,6,0,6
7,Top,12,4,2,0,2
7,Top,12,5,2,0,2
7,Top,12,6,2,0,2
7,Top,13,0,1,0,1
7,Top,13,1,1,0,1
7,Top,13,3,1,0,1
7,Top,13,4,1,0,1
7,Top,13,5,2,0,2
7,Top,13,6,1,0,1
7,Top,13,7,1,0,1
7,Top,13,10,0,1,1
7,Top,14,1,3,0,3
7,Top,14,2,1,0,1
7,Top,14,3,1,0,1
7,Top,14,6,2,0,2
7,Top,15,0,1,0,1
7,Top,15,3,1,0,1
7,Top,15,4,1,0,1
7,Top,15,5,1,0,1
7,Top,15,8,1,0,1
7,Top,15,9,1,0,1
7,Top,16,1,1,0,1
7,Top,16,3,1,0,1
7,Top,16,4,1,0,1
7,Top,16,5,1,0,1
7,Top,17,1,1,0,1
7,Top,17,2,1,0,1
7,Top,17,3,1,0,1
7,Top,17,5,1,0,1
7,Top,17,7,1,0,1
7,Top,18,2,1,0,1
7,Top,19,1,2,0,2
7,Top,19,2,1,0,1
8,Bot,0,0,0,16,16
8,Bot,0,1,0,50,50
8,Bot,0,2,0,57,57
8,Bot,0,3,0,32,32
8,Bot,0,4,0,46,46
8,Bot,0,5,0,36,36
8,Bot,0,6,0,24,24
8,Bot,0,7,0,26,26
8,Bot,0,8,0,15,15
8,Bot,0,9,0,20,20
8,Bot,0,10,0,9,9
8,Bot,0,11,0,7,7
8,Bot,0,12,0,2,2
8,Bot,0,13,0,1,1
8,Bot,0,14,0,2,2
8,Bot,0,15,0,1,1
8,Bot,0,16,0,1,1
8,Bot,1,0,30,6,36
8,Bot,1,1,0,51,51
8,Bot,1,2,0,76,76
8,Bot,1,3,0,82,82
8,Bot,1,4,0,65,65
8,Bot,1,5,0,60,60
8,Bot,1,6,0,51,51
8,Bot,1,7,0,31,31
8,Bot,1,8,0,22,22
8,Bot,1,9,0,15,15
8,Bot,1,10,0,9,9
8,Bot,1,11,0,13,13
8,Bot,1,12,0,4,4
8,Bot,1,13,0,5,5
8,Bot,2,0,48,4,52
8,Bot,2,1,62,11,73
8,Bot,2,2,1,40,41
8,Bot,2,3,0,72,72
8,Bot,2,4,0,81,81
8,Bot,2,5,0,63,63
8,Bot,2,6,0,57,57
8,Bot,2,7,0,26,26
8,Bot,2,8,0,33,33
8,Bot,2,9,0,18,18
8,Bot,2,10,0,16,16
8,Bot,2,11,0,9,9
8,Bot,2,12,0,6,6
8,Bot,2,13,0,2,2
8,Bot,2,14,0,3,3
8,Bot,2,15,0,3,3
8,Bot,2,16,0,1,1
8,Bot,2,17,0,1,1
8,Bot,2,18,0,1,1
8,Bot,2,20,0,1,1
8,Bot,3,0,56,3,59
8,Bot,3,1,80,5,85
8,Bot,3,2,64,11,75
8,Bot,3,3,0,52,52
8,Bot,3,4,0,64,64
8,Bot,3,5,0,63,63
8,Bot,3,6,0,64,64
8,Bot,3,7,0,39,39
8,Bot,3,8,0,35,35
8,Bot,3,9,0,26,26
8,Bot,3,10,0,13,13
8,Bot,3,11,0,9,9
8,Bot,3,12,0,4,4
8,Bot,3,13,0,3,3
8,Bot,3,15,0,3,3
8,Bot,3,18,0,1,1
8,Bot,4,0,61,1,62
8,Bot,4,1,79,0,79
8,Bot,4,2,81,8,89
8,Bot,4,3,57,13,70
8,Bot,4,4,0,33,33
8,Bot,4,5,0,69,69
8,Bot,4,6,0,47,47
8,Bot,4,7,0,25,25
8,Bot,4,8,0,30,30
8,Bot,4,9,0,16,16
8,Bot,4,10,0,16,16
8,Bot,4,11,0,5,5
8,Bot,4,12,0,6,6
8,Bot,4,13,0,5,5
8,Bot,4,14,0,2,2
8,Bot,4,15,0,1,1
8,Bot,4,18,0,2,2
8,Bot,4,19,0,1,1
8,Bot,4,22,0,1,1
8,Bot,5,0,39,0,39
8,Bot,5,1,66,2,68
8,Bot,5,2,79,2,81
8,Bot,5,3,76,1,77
8,Bot,5,4,47,10,57
8,Bot,5,5,1,28,29
8,Bot,5,6,0,29,29
8,Bot,5,7,0,31,31
8,Bot,5,8,0,32,32
8,Bot,5,9,0,17,17
8,Bot,5,10,0,13,13
8,Bot,5,11,0,9,9
8,Bot,5,12,0,5,5
8,Bot,5,13,0,3,3
8,Bot,5,14,0,1,1
8,Bot,5,18,0,1,1
8,Bot,5,19,0,1,1
8,Bot,5,20,0,1,1
8,Bot,6,0,37,0,37
8,Bot,6,1,46,0,46
8,Bot,6,2,67,0,67
8,Bot,6,3,60,2,62
8,Bot,6,4,43,4,47
8,Bot,6,5,31,2,33
8,Bot,6,6,0,12,12
8,Bot,6,7,0,16,16
8,Bot,6,8,0,17,17
8,Bot,6,9,0,10,10
8,Bot,6,10,0,9,9
8,Bot,6,11,0,4,4
8,Bot,6,12,0,3,3
8,Bot,6,14,0,3,3
8,Bot,6,15,0,1,1
8,Bot,6,16,0,1,1
8,Bot,7,0,21,0,21
8,Bot,7,1,27,0,27
8,Bot,7,2,52,0,52
8,Bot,7,3,43,1,44
8,Bot,7,4,35,1,36
8,Bot,7,5,25,2,27
8,Bot,7,6,10,3,13
8,Bot,7,7,0,9,9
8,Bot,7,8,0,10,10
8,Bot,7,9,0,7,7
8,Bot,7,10,0,4,4
8,Bot,7,11,0,3,3
8,Bot,7,12,0,3,3
8,Bot,7,15,0,2,2
8,Bot,8,0,22,0,22
8,Bot,8,1,21,0,21
8,Bot,8,2,32,0,32
8,Bot,8,3,36,0,36
8,Bot,8,4,31,0,31
8,Bot,8,5,18,0,18
8,Bot,8,6,22,0,22
8,Bot,8,7,10,4,14
8,Bot,8,8,0,1,1
8,Bot,8,9,0,7,7
8,Bot,8,11,0,2,2
8,Bot,8,12,0,2,2
8,Bot,8,14,0,1,1
8,Bot,9,0,18,0,18
8,Bot,9,1,23,0,23
8,Bot,9,2,19,0,19
8,Bot,9,3,22,0,22
8,Bot,9,4,22,0,22
8,Bot,9,5,16,1,17
8,Bot,9,6,13,0,13
8,Bot,9,7,6,0,6
8,Bot,9,8,2,0,2
8,Bot,9,9,0,1,1
8,Bot,9,10,0,3,3
8,Bot,9,11,0,1,1
8,Bot,9,12,0,2,2
8,Bot,9,14,0,1,1
8,Bot,9,15,0,1,1
8,Bot,10,0,16,0,16
8,Bot,10,1,16,0,16
8,Bot,10,2,18,0,18
8,Bot,10,3,15,0,15
8,Bot,10,4,19,0,19
8,Bot,10,5,15,0,15
8,Bot,10,6,15,0,15
8,Bot,10,7,5,0,5
8,Bot,10,8,7,2,9
8,Bot,10,9,2,1,3
8,Bot,10,10,0,1,1
8,Bot,10,12,0,2,2
8,Bot,11,0,8,0,8
8,Bot,11,1,14,0,14
8,Bot,11,2,14,0,14
8,Bot,11,3,12,0,12
8,Bot,11,4,16,0,16
8,Bot,11,5,13,1,14
8,Bot,11,6,5,0,5
8,Bot,11,7,4,0,4
8,Bot,11,8,4,1,5
8,Bot,11,9,3,0,3
8,Bot,11,10,2,2,4
8,Bot,11,11,0,1,1
8,Bot,11,19,0,1,1
8,Bot,12,0,3,0,3
8,Bot,12,1,3,0,3
8,Bot,12,2,8,0,8
8,Bot,12,3,9,0,9
8,Bot,12,4,10,0,10
8,Bot,12,5,5,0,5
8,Bot,12,6,6,0,6
8,Bot,12,7,1,0,1
8,Bot,12,9,3,0,3
8,Bot,12,10,1,0,1
8,Bot,12,11,1,0,1
8,Bot,13,0,4,0,4
8,Bot,13,1,2,0,2
8,Bot,13,2,4,0,4
8,Bot,13,3,4,0,4
8,Bot,13,4,2,0,2
8,Bot,13,5,4,0,4
8,Bot,13,6,4,0,4
8,Bot,13,7,3,0,3
8,Bot,13,8,2,0,2
8,Bot,13,9,4,0,4
8,Bot,13,10,0,1,1
8,Bot,13,17,0,1,1
8,Bot,14,0,4,0,4
8,Bot,14,1,5,0,5
8,Bot,14,2,5,0,5
8,Bot,14,3,3,0,3
8,Bot,14,4,1,0,1
8,Bot,14,5,2,0,2
8,Bot,14,6,2,0,2
8,Bot,14,7,2,0,2
8,Bot,14,8,1,0,1
8,Bot,14,9,1,0,1
8,Bot,14,10,2,0,2
8,Bot,14,12,1,0,1
8,Bot,15,0,2,0,2
8,Bot,15,1,2,0,2
8,Bot,15,2,1,0,1
8,Bot,15,3,3,0,3
8,Bot,15,5,2,0,2
8,Bot,15,6,2,0,2
8,Bot,15,8,1,0,1
8,Bot,16,2,1,0,1
8,Bot,16,3,1,0,1
8,Bot,16,4,2,0,2
8,Bot,16,6,1,0,1
8,Bot,16,7,1,0,1
8,Bot,17,1,2,0,2
8,Bot,17,4,1,0,1
8,Bot,17,5,2,0,2
8,Bot,17,6,1,0,1
8,Bot,17,8,1,0,1
8,Bot,18,2,1,0,1
8,Bot,18,4,2,0,2
8,Bot,18,5,2,0,2
8,Bot,19,2,1,0,1
8,Bot,19,3,3,0,3
8,Bot,19,4,1,0,1
8,Bot,19,9,1,0,1
8,Bot,20,1,1,0,1
8,Bot,20,5,1,0,1
8,Bot,21,1,1,0,1
8,Bot,21,2,1,0,1
8,Bot,21,5,1,0,1
8,Bot,25,1,1,0,1
8,Top,0,0,3,16,19
8,Top,0,1,5,59,64
8,Top,0,2,5,66,71
8,Top,0,3,0,43,43
8,Top,0,4,0,60,60
8,Top,0,5,0,46,46
8,Top,0,6,0,30,30
8,Top,0,7,0,36,36
8,Top,0,8,0,22,22
8,Top,0,9,0,20,20
8,Top,0,10,0,9,9
8,Top,0,11,0,7,7
8,Top,0,12,0,3,3
8,Top,0,13,0,1,1
8,Top,0,14,0,2,2
8,Top,0,15,0,1,1
8,Top,0,16,0,1,1
8,Top,1,0,49,7,56
8,Top,1,1,19,45,64
8,Top,1,2,7,74,81
8,Top,1,3,4,90,94
8,Top,1,4,1,79,80
8,Top,1,5,1,70,71
8,Top,1,6,0,64,64
8,Top,1,7,0,33,33
8,Top,1,8,0,25,25
8,Top,1,9,0,19,19
8,Top,1,10,0,10,10
8,Top,1,11,0,13,13
8,Top,1,12,0,3,3
8,Top,1,13,0,5,5
8,Top,1,14,0,1,1
8,Top,1,15,0,2,2
8,Top,2,0,63,5,68
8,Top,2,1,74,10,84
8,Top,2,2,28,37,65
8,Top,2,3,11,68,79
8,Top,2,4,5,79,84
8,Top,2,5,0,69,69
8,Top,2,6,0,62,62
8,Top,2,7,1,27,28
8,Top,2,8,0,40,40
8,Top,2,9,0,20,20
8,Top,2,10,0,19,19
8,Top,2,11,0,12,12
8,Top,2,12,0,10,10
8,Top,2,13,0,2,2
8,Top,2,14,0,3,3
8,Top,2,15,0,3,3
8,Top,2,16,0,1,1
8,Top,2,17,0,1,1
8,Top,2,18,0,1,1
8,Top,2,20,0,1,1
8,Top,3,0,51,1,52
8,Top,3,1,78,3,81
8,Top,3,2,87,10,97
8,Top,3,3,18,43,61
8,Top,3,4,7,46,53
8,Top,3,5,5,61,66
8,Top,3,6,0,57,57
8,Top,3,7,1,43,44
8,Top,3,8,0,42,42
8,Top,3,9,0,24,24
8,Top,3,10,0,19,19
8,Top,3,11,0,10,10
8,Top,3,13,0,4,4
8,Top,3,15,0,1,1
8,Top,3,18,0,1,1
8,Top,3,19,0,1,1
8,Top,4,0,56,1,57
8,Top,4,1,77,0,77
8,Top,4,2,85,8,93
8,Top,4,3,78,8,86
8,Top,4,4,11,30,41
8,Top,4,5,2,57,59
8,Top,4,6,2,46,48
8,Top,4,7,2,23,25
8,Top,4,8,0,25,25
8,Top,4,9,0,16,16
8,Top,4,10,0,13,13
8,Top,4,11,0,9,9
8,Top,4,12,0,9,9
8,Top,4,13,0,5,5
8,Top,4,14,0,2,2
8,Top,4,15,0,2,2
8,Top,4,18,0,3,3
8,Top,4,19,0,1,1
8,Top,4,22,0,1,1
8,Top,5,0,37,0,37
8,Top,5,1,63,2,65
8,Top,5,2,64,0,64
8,Top,5,3,65,1,66
8,Top,5,4,49,6,55
8,Top,5,5,11,19,30
8,Top,5,6,5,18,23
8,Top,5,7,3,26,29
8,Top,5,8,0,29,29
8,Top,5,9,0,17,17
8,Top,5,10,1,11,12
8,Top,5,11,0,5,5
8,Top,5,12,0,4,4
8,Top,5,13,0,2,2
8,Top,5,14,0,2,2
8,Top,5,15,0,1,1
8,Top,5,20,0,1,1
8,Top,6,0,30,0,30
8,Top,6,1,42,0,42
8,Top,6,2,53,0,53
8,Top,6,3,49,1,50
8,Top,6,4,44,3,47
8,Top,6,5,29,2,31
8,Top,6,6,10,7,17
8,Top,6,7,1,13,14
8,Top,6,8,0,7,7
8,Top,6,9,0,7,7
8,Top,6,10,0,5,5
8,Top,6,11,0,2,2
8,Top,6,12,0,3,3
8,Top,6,14,0,3,3
8,Top,6,15,0,1,1
8,Top,6,16,0,1,1
8,Top,7,0,20,0,20
8,Top,7,1,24,0,24
8,Top,7,2,40,0,40
8,Top,7,3,32,1,33
8,Top,7,4,32,1,33
8,Top,7,5,33,1,34
8,Top,7,6,11,2,13
8,Top,7,7,2,6,8
8,Top,7,8,1,4,5
8,Top,7,9,0,7,7
8,Top,7,10,0,4,4
8,Top,7,11,0,2,2
8,Top,7,12,0,4,4
8,Top,8,0,18,0,18
8,Top,8,1,21,0,21
8,Top,8,2,25,0,25
8,Top,8,3,30,0,30
8,Top,8,4,26,0,26
8,Top,8,5,14,1,15
8,Top,8,6,12,0,12
8,Top,8,7,6,1,7
8,Top,8,8,0,1,1
8,Top,8,9,1,5,6
8,Top,8,10,0,0,0
8,Top,8,11,0,2,2
8,Top,8,12,0,1,1
8,Top,9,0,16,0,16
8,Top,9,1,17,0,17
8,Top,9,2,18,0,18
8,Top,9,3,13,0,13
8,Top,9,4,20,0,20
8,Top,9,5,11,0,11
8,Top,9,6,14,0,14
8,Top,9,7,2,0,2
8,Top,9,8,6,0,6
8,Top,9,9,1,1,2
8,Top,9,10,0,4,4
8,Top,9,12,0,1,1
8,Top,9,15,0,1,1
8,Top,10,0,18,0,18
8,Top,10,1,12,0,12
8,Top,10,2,11,0,11
8,Top,10,3,19,0,19
8,Top,10,4,16,0,16
8,Top,10,5,8,0,8
8,Top,10,6,10,0,10
8,Top,10,7,5,0,5
8,Top,10,8,5,1,6
8,Top,10,9,4,1,5
8,Top,10,10,0,0,0
8,Top,10,11,1,1,2
8,Top,10,12,0,1,1
8,Top,10,19,0,1,1
8,Top,11,0,2,0,2
8,Top,11,1,7,0,7
8,Top,11,2,12,0,12
8,Top,11,3,8,0,8
8,Top,11,4,11,0,11
8,Top,11,5,13,1,14
8,Top,11,6,5,0,5
8,Top,11,7,3,0,3
8,Top,11,8,2,1,3
8,Top,11,9,4,0,4
8,Top,11,10,3,1,4
8,Top,11,11,0,0,0
8,Top,12,1,3,0,3
8,Top,12,2,5,0,5
8,Top,12,3,7,0,7
8,Top,12,4,6,0,6
8,Top,12,5,2,0,2
8,Top,12,6,5,0,5
8,Top,12,7,1,0,1
8,Top,12,9,2,0,2
8,Top,13,0,3,0,3
8,Top,13,2,2,0,2
8,Top,13,3,3,0,3
8,Top,13,5,3,0,3
8,Top,13,6,2,0,2
8,Top,13,7,3,0,3
8,Top,13,8,1,0,1
8,Top,13,10,0,1,1
8,Top,13,17,0,1,1
8,Top,14,0,2,0,2
8,Top,14,1,2,0,2
8,Top,14,2,3,0,3
8,Top,14,3,3,0,3
8,Top,14,5,1,0,1
8,Top,14,6,3,0,3
8,Top,14,7,1,0,1
8,Top,14,8,1,0,1
8,Top,14,9,1,0,1
8,Top,14,10,1,0,1
8,Top,14,12,1,0,1
8,Top,15,0,2,0,2
8,Top,15,1,2,0,2
8,Top,15,3,2,0,2
8,Top,15,4,1,0,1
8,Top,15,5,1,0,1
8,Top,15,6,1,0,1
8,Top,15,8,1,0,1
8,Top,15,9,1,0,1
8,Top,16,2,1,0,1
8,Top,16,3,1,0,1
8,Top,16,4,1,0,1
8,Top,16,5,1,0,1
8,Top,16,7,1,0,1
8,Top,17,1,2,0,2
8,Top,17,3,1,0,1
8,Top,17,5,1,0,1
8,Top,17,6,1,0,1
8,Top,17,8,1,0,1
8,Top,18,4,1,0,1
8,Top,19,1,1,0,1
8,Top,19,2,1,0,1
8,Top,19,4,1,0,1
8,Top,19,5,1,0,1
8,Top,20,1,1,0,1
8,Top,21,1,1,0,1
8,Top,21,2,1,0,1
8,Top,21,5,1,0,1
9,Bot,0,0,0,8,8
9,Bot,0,1,0,40,40
9,Bot,0,2,0,50,50
9,Bot,0,3,0,23,23
9,Bot,0,4,0,38,38
9,Bot,0,5,0,26,26
9,Bot,0,6,0,21,21
9,Bot,0,7,0,23,23
9,Bot,0,8,0,9,9
9,Bot,0,9,0,11,11
9,Bot,0,10,0,5,5
9,Bot,0,11,0,7,7
9,Bot,0,12,0,1,1
9,Bot,0,13,0,3,3
9,Bot,0,14,0,1,1
9,Bot,0,15,0,2,2
9,Bot,0,16,0,2,2
9,Bot,1,1,0,28,28
9,Bot,1,2,0,70,70
9,Bot,1,3,0,71,71
9,Bot,1,4,0,62,62
9,Bot,1,5,0,59,59
9,Bot,1,6,0,35,35
9,Bot,1,7,0,34,34
9,Bot,1,8,0,21,21
9,Bot,1,9,0,17,17
9,Bot,1,10,0,12,12
9,Bot,1,11,0,7,7
9,Bot,1,12,0,9,9
9,Bot,1,14,0,3,3
9,Bot,1,15,0,3,3
9,Bot,1,16,0,1,1
9,Bot,2,2,0,34,34
9,Bot,2,3,0,78,78
9,Bot,2,4,0,63,63
9,Bot,2,5,0,61,61
9,Bot,2,6,0,51,51
9,Bot,2,7,0,44,44
9,Bot,2,8,0,36,36
9,Bot,2,9,0,25,25
9,Bot,2,10,0,20,20
9,Bot,2,11,0,12,12
9,Bot,2,12,0,9,9
9,Bot,2,13,0,4,4
9,Bot,2,14,0,6,6
9,Bot,2,15,0,2,2
9,Bot,2,16,0,2,2
9,Bot,2,18,0,1,1
9,Bot,2,19,0,1,1
9,Bot,2,23,0,1,1
9,Bot,3,3,0,46,46
9,Bot,3,4,0,69,69
9,Bot,3,5,0,74,74
9,Bot,3,6,0,57,57
9,Bot,3,7,0,41,41
9,Bot,3,8,0,37,37
9,Bot,3,9,0,24,24
9,Bot,3,10,0,18,18
9,Bot,3,11,0,7,7
9,Bot,3,12,0,6,6
9,Bot,3,13,0,2,2
9,Bot,3,14,0,1,1
9,Bot,3,15,0,4,4
9,Bot,3,16,0,1,1
9,Bot,3,17,0,1,1
9,Bot,4,4,0,40,40
9,Bot,4,5,0,81,81
9,Bot,4,6,0,46,46
9,Bot,4,7,0,40,40
9,Bot,4,8,0,29,29
9,Bot,4,9,0,33,33
9,Bot,4,10,0,13,13
9,Bot,4,11,0,17,17
9,Bot,4,12,0,10,10
9,Bot,4,13,0,5,5
9,Bot,4,14,0,3,3
9,Bot,4,15,0,1,1
9,Bot,4,16,0,1,1
9,Bot,4,17,0,1,1
9,Bot,4,18,0,1,1
9,Bot,4,19,0,3,3
9,Bot,4,24,0,1,1
9,Bot,5,5,0,18,18
9,Bot,5,6,0,51,51
9,Bot,5,7,0,32,32
9,Bot,5,8,0,35,35
9,Bot,5,9,0,21,21
9,Bot,5,10,0,20,20
9,Bot,5,11,0,12,12
9,Bot,5,12,0,6,6
9,Bot,5,13,0,5,5
9,Bot,5,16,0,2,2
9,Bot,5,17,0,1,1
9,Bot,5,18,0,1,1
9,Bot,5,19,0,1,1
9,Bot,6,6,0,19,19
9,Bot,6,7,0,24,24
9,Bot,6,8,0,21,21
9,Bot,6,9,0,16,16
9,Bot,6,10,0,9,9
9,Bot,6,11,0,9,9
9,Bot,6,12,0,6,6
9,Bot,6,13,0,3,3
9,Bot,6,14,0,3,3
9,Bot,6,15,0,1,1
9,Bot,6,16,0,1,1
9,Bot,6,17,0,1,1
9,Bot,6,19,0,1,1
9,Bot,7,7,0,7,7
9,Bot,7,8,0,22,22
9,Bot,7,9,0,12,12
9,Bot,7,10,0,10,10
9,Bot,7,11,0,6,6
9,Bot,7,12,0,4,4
9,Bot,7,13,0,1,1
9,Bot,7,14,0,1,1
9,Bot,7,15,0,2,2
9,Bot,7,16,0,2,2
9,Bot,7,17,0,1,1
9,Bot,7,21,0,1,1
9,Bot,8,8,0,3,3
9,Bot,8,9,0,12,12
9,Bot,8,10,0,3,3
9,Bot,8,11,0,6,6
9,Bot,8,12,0,3,3
9,Bot,8,13,0,1,1
9,Bot,8,14,0,3,3
9,Bot,9,9,0,1,1
9,Bot,9,10,0,5,5
9,Bot,9,12,0,1,1
9,Bot,9,13,0,1,1
9,Bot,9,14,0,2,2
9,Bot,9,15,0,1,1
9,Bot,9,17,0,1,1
9,Bot,10,10,0,3,3
9,Bot,10,11,0,3,3
9,Bot,10,12,0,1,1
9,Bot,10,13,0,1,1
9,Bot,11,11,0,3,3
9,Bot,11,12,0,3,3
9,Bot,12,12,0,2,2
9,Bot,12,19,0,1,1
9,Bot,13,14,0,1,1
9,Bot,13,17,0,1,1
9,Top,0,0,0,8,8
9,Top,0,1,0,42,42
9,Top,0,2,0,55,55
9,Top,0,3,0,31,31
9,Top,0,4,0,47,47
9,Top,0,5,0,37,37
9,Top,0,6,0,27,27
9,Top,0,7,0,32,32
9,Top,0,8,0,15,15
9,Top,0,9,0,18,18
9,Top,0,10,0,10,10
9,Top,0,11,0,9,9
9,Top,0,12,0,2,2
9,Top,0,13,0,3,3
9,Top,0,14,0,2,2
9,Top,0,15,0,3,3
9,Top,0,16,0,2,2
9,Top,0,17,0,1,1
9,Top,1,0,30,0,30
9,Top,1,1,0,28,28
9,Top,1,2,0,68,68
9,Top,1,3,0,80,80
9,Top,1,4,0,69,69
9,Top,1,5,0,65,65
9,Top,1,6,0,43,43
9,Top,1,7,0,46,46
9,Top,1,8,0,29,29
9,Top,1,9,0,19,19
9,Top,1,10,0,12,12
9,Top,1,11,0,11,11
9,Top,1,12,0,10,10
9,Top,1,13,0,3,3
9,Top,1,14,0,4,4
9,Top,1,15,0,2,2
9,Top,1,16,0,2,2
9,Top,2,0,40,0,40
9,Top,2,1,68,1,69
9,Top,2,2,0,28,28
9,Top,2,3,0,70,70
9,Top,2,4,0,68,68
9,Top,2,5,0,68,68
9,Top,2,6,0,54,54
9,Top,2,7,0,36,36
9,Top,2,8,0,37,37
9,Top,2,9,0,24,24
9,Top,2,10,0,24,24
9,Top,2,11,0,13,13
9,Top,2,12,0,10,10
9,Top,2,13,0,2,2
9,Top,2,14,0,5,5
9,Top,2,15,0,2,2
9,Top,2,16,0,3,3
9,Top,2,18,0,1,1
9,Top,2,19,0,1,1
9,Top,2,23,0,1,1
9,Top,3,0,46,0,46
9,Top,3,1,77,1,78
9,Top,3,2,77,0,77
9,Top,3,3,0,37,37
9,Top,3,4,0,59,59
9,Top,3,5,0,72,72
9,Top,3,6,0,61,61
9,Top,3,7,0,48,48
9,Top,3,8,0,39,39
9,Top,3,9,0,30,30
9,Top,3,10,0,18,18
9,Top,3,11,0,13,13
9,Top,3,12,0,6,6
9,Top,3,13,0,2,2
9,Top,3,14,0,2,2
9,Top,3,15,0,5,5
9,Top,3,16,0,1,1
9,Top,3,19,0,1,1
9,Top,4,0,43,0,43
9,Top,4,1,77,0,77
9,Top,4,2,86,0,86
9,Top,4,3,68,2,70
9,Top,4,4,0,27,27
9,Top,4,5,0,68,68
9,Top,4,6,0,44,44
9,Top,4,7,0,29,29
9,Top,4,8,0,30,30
9,Top,4,9,0,28,28
9,Top,4,10,0,14,14
9,Top,4,11,0,12,12
9,Top,4,12,0,7,7
9,Top,4,13,0,6,6
9,Top,4,14,0,5,5
9,Top,4,15,0,1,1
9,Top,4,16,0,1,1
9,Top,4,17,0,2,2
9,Top,4,18,0,1,1
9,Top,4,19,0,2,2
9,Top,4,24,0,1,1
9,Top,5,0,31,0,31
9,Top,5,1,58,0,58
9,Top,5,2,72,0,72
9,Top,5,3,84,0,84
9,Top,5,4,65,0,65
9,Top,5,5,0,12,12
9,Top,5,6,0,40,40
9,Top,5,7,0,29,29
9,Top,5,8,0,29,29
9,Top,5,9,0,23,23
9,Top,5,10,0,20,20
9,Top,5,11,0,13,13
9,Top,5,12,0,11,11
9,Top,5,13,0,5,5
9,Top,5,16,0,2,2
9,Top,5,18,0,1,1
9,Top,5,19,0,1,1
9,Top,5,21,0,1,1
9,Top,6,0,24,0,24
9,Top,6,1,39,0,39
9,Top,6,2,59,0,59
9,Top,6,3,68,0,68
9,Top,6,4,50,0,50
9,Top,6,5,46,0,46
9,Top,6,6,0,9,9
9,Top,6,7,0,18,18
9,Top,6,8,0,21,21
9,Top,6,9,0,12,12
9,Top,6,10,0,6,6
9,Top,6,11,0,7,7
9,Top,6,12,0,4,4
9,Top,6,13,0,2,2
9,Top,6,14,0,2,2
9,Top,6,15,0,1,1
9,Top,6,17,0,1,1
9,Top,6,19,0,1,1
9,Top,7,0,18,0,18
9,Top,7,1,21,0,21
9,Top,7,2,46,0,46
9,Top,7,3,43,0,43
9,Top,7,4,38,0,38
9,Top,7,5,28,0,28
9,Top,7,6,18,0,18
9,Top,7,7,0,5,5
9,Top,7,8,0,14,14
9,Top,7,9,0,8,8
9,Top,7,10,0,6,6
9,Top,7,11,0,4,4
9,Top,7,12,0,3,3
9,Top,7,13,0,1,1
9,Top,7,14,0,1,1
9,Top,7,15,0,1,1
9,Top,7,16,0,1,1
9,Top,7,17,0,1,1
9,Top,8,0,17,0,17
9,Top,8,1,18,0,18
9,Top,8,2,27,0,27
9,Top,8,3,39,0,39
9,Top,8,4,29,0,29
9,Top,8,5,20,0,20
9,Top,8,6,24,0,24
9,Top,8,7,19,0,19
9,Top,8,8,0,1,1
9,Top,8,9,0,8,8
9,Top,8,10,0,1,1
9,Top,8,11,0,1,1
9,Top,8,12,0,3,3
9,Top,8,14,0,1,1
9,Top,8,15,0,1,1
9,Top,9,0,15,0,15
9,Top,9,1,17,0,17
9,Top,9,2,18,0,18
9,Top,9,3,22,0,22
9,Top,9,4,21,0,21
9,Top,9,5,16,0,16
9,Top,9,6,20,0,20
9,Top,9,7,7,0,7
9,Top,9,8,5,0,5
9,Top,9,9,0,1,1
9,Top,9,10,0,3,3
9,Top,9,11,0,2,2
9,Top,9,12,0,2,2
9,Top,9,13,0,1,1
9,Top,9,14,0,1,1
9,Top,9,17,0,1,1
9,Top,10,0,9,0,9
9,Top,10,1,16,0,16
9,Top,10,2,14,0,14
9,Top,10,3,17,0,17
9,Top,10,4,19,0,19
9,Top,10,5,14,0,14
9,Top,10,6,14,0,14
9,Top,10,7,10,0,10
9,Top,10,8,10,0,10
9,Top,10,9,4,0,4
9,Top,10,10,0,3,3
9,Top,10,11,0,1,1
9,Top,10,12,0,1,1
9,Top,10,13,0,1,1
9,Top,11,0,6,0,6
9,Top,11,1,9,0,9
9,Top,11,2,14,0,14
9,Top,11,3,13,0,13
9,Top,11,4,17,0,17
9,Top,11,5,13,0,13
9,Top,11,6,7,0,7
9,Top,11,7,5,0,5
9,Top,11,8,5,0,5
9,Top,11,9,4,0,4
9,Top,11,10,3,0,3
9,Top,11,11,0,3,3
9,Top,11,12,0,2,2
9,Top,11,19,0,1,1
9,Top,12,0,2,0,2
9,Top,12,1,4,0,4
9,Top,12,2,6,0,6
9,Top,12,3,7,0,7
9,Top,12,4,9,0,9
9,Top,12,5,8,0,8
9,Top,12,6,4,0,4
9,Top,12,7,2,0,2
9,Top,12,8,3,0,3
9,Top,12,9,1,0,1
9,Top,12,10,2,0,2
9,Top,12,11,2,0,2
9,Top,13,0,4,0,4
9,Top,13,1,1,0,1
9,Top,13,2,4,0,4
9,Top,13,3,2,0,2
9,Top,13,4,3,0,3
9,Top,13,5,5,0,5
9,Top,13,6,2,0,2
9,Top,13,7,4,0,4
9,Top,13,8,3,0,3
9,Top,13,9,3,0,3
9,Top,13,10,2,0,2
9,Top,13,14,0,1,1
9,Top,13,17,0,1,1
9,Top,14,0,4,0,4
9,Top,14,1,5,0,5
9,Top,14,2,4,0,4
9,Top,14,3,4,0,4
9,Top,14,4,1,0,1
9,Top,14,5,2,0,2
9,Top,14,6,2,0,2
9,Top,14,7,2,0,2
9,Top,14,8,1,0,1
9,Top,14,9,1,0,1
9,Top,14,10,2,0,2
9,Top,14,12,1,0,1
9,Top,15,0,2,0,2
9,Top,15,1,2,0,2
9,Top,15,2,1,0,1
9,Top,15,5,4,0,4
9,Top,15,6,1,0,1
9,Top,15,7,1,0,1
9,Top,15,8,2,0,2
9,Top,16,2,1,0,1
9,Top,16,3,1,0,1
9,Top,16,4,1,0,1
9,Top,16,6,1,0,1
9,Top,16,8,1,0,1
9,Top,16,9,1,0,1
9,Top,17,1,2,0,2
9,Top,17,4,1,0,1
9,Top,17,6,1,0,1
9,Top,17,7,1,0,1
9,Top,17,8,2,0,2
9,Top,18,4,2,0,2
9,Top,18,5,2,0,2
9,Top,18,7,1,0,1
9,Top,19,2,1,0,1
9,Top,19,3,2,0,2
9,Top,19,4,2,0,2
9,Top,19,11,1,0,1
9,Top,20,1,1,0,1
9,Top,20,5,1,0,1
9,Top,21,1,1,0,1
9,Top,21,3,1,0,1
9,Top,21,5,1,0,1
9,Top,25,4,1,0,1
10,Bot,0,0,0,7,7
10,Bot,0,2,0,1,1
10,Bot,1,1,0,19,19
10,Bot,1,2,0,3,3
10,Bot,1,3,0,3,3
10,Bot,1,5,0,2,2
10,Bot,2,2,0,15,15
10,Bot,2,3,0,11,11
10,Bot,2,4,0,2,2
10,Bot,2,5,0,1,1
10,Bot,2,8,0,1,1
10,Bot,3,3,0,28,28
10,Bot,3,4,0,9,9
10,Bot,3,5,0,4,4
10,Bot,3,6,0,2,2
10,Bot,3,7,0,1,1
10,Bot,3,8,0,1,1
10,Bot,3,9,0,1,1
10,Bot,4,4,0,18,18
10,Bot,4,5,0,15,15
10,Bot,4,6,0,5,5
10,Bot,4,7,0,1,1
10,Bot,4,8,0,2,2
10,Bot,4,10,0,1,1
10,Bot,5,5,0,11,11
10,Bot,5,6,0,5,5
10,Bot,5,7,0,3,3
10,Bot,6,6,0,7,7
10,Bot,6,7,0,9,9
10,Bot,6,8,0,1,1
10,Bot,6,9,0,1,1
10,Bot,6,10,0,1,1
10,Bot,7,7,0,6,6
10,Bot,7,9,0,1,1
10,Bot,7,10,0,2,2
10,Bot,8,8,0,2,2
10,Bot,8,9,0,1,1
10,Bot,9,9,0,2,2
10,Bot,10,10,0,1,1
10,Bot,10,11,0,1,1
10,Bot,10,13,0,1,1
10,Bot,11,11,0,2,2
10,Bot,12,12,0,1,1
10,Bot,12,13,0,1,1
10,Bot,12,14,0,1,1
10,Top,0,0,0,7,7
10,Top,0,2,0,1,1
10,Top,1,1,0,19,19
10,Top,1,2,0,3,3
10,Top,1,3,0,4,4
10,Top,1,5,0,2,2
10,Top,2,2,0,16,16
10,Top,2,3,0,10,10
10,Top,2,4,0,4,4
10,Top,2,5,0,1,1
10,Top,2,6,0,2,2
10,Top,2,8,0,2,2
10,Top,3,3,0,27,27
10,Top,3,4,0,7,7
10,Top,3,5,0,5,5
10,Top,3,6,0,3,3
10,Top,3,7,0,1,1
10,Top,3,8,0,2,2
10,Top,3,9,0,1,1
10,Top,4,4,0,18,18
10,Top,4,5,0,14,14
10,Top,4,6,0,3,3
10,Top,4,7,0,3,3
10,Top,4,8,0,1,1
10,Top,4,10,0,1,1
10,Top,5,5,0,11,11
10,Top,5,6,0,5,5
10,Top,5,7,0,1,1
10,Top,5,10,0,1,1
10,Top,6,6,0,6,6
10,Top,6,7,0,10,10
10,Top,6,9,0,1,1
10,Top,6,10,0,2,2
10,Top,7,7,0,5,5
10,Top,7,9,0,2,2
10,Top,8,8,0,2,2
10,Top,8,9,0,1,1
10,Top,9,9,0,1,1
10,Top,10,10,0,1,1
10,Top,10,11,0,1,1
10,Top,10,13,0,1,1
10,Top,11,11,0,2,2
10,Top,11,12,0,1,1
10,Top,12,12,0,1,1
10,Top,12,14,0,1,1
11,Bot,0,0,0,5,5
11,Bot,0,1,0,1,1
11,Bot,1,1,0,9,9
11,Bot,1,2,0,9,9
11,Bot,1,4,0,1,1
11,Bot,2,2,0,9,9
11,Bot,2,3,0,2,2
11,Bot,2,4,0,1,1
11,Bot,2,5,0,1,1
11,Bot,2,6,0,1,1
11,Bot,2,7,0,1,1
11,Bot,3,3,0,18,18
11,Bot,3,4,0,6,6
11,Bot,3,5,0,3,3
11,Bot,3,6,0,1,1
11,Bot,4,4,0,9,9
11,Bot,4,5,0,5,5
11,Bot,4,6,0,2,2
11,Bot,4,7,0,2,2
11,Bot,4,8,0,1,1
11,Bot,5,5,0,5,5
11,Bot,5,6,0,3,3
11,Bot,5,7,0,2,2
11,Bot,6,6,0,4,4
11,Bot,6,7,0,2,2
11,Bot,6,12,0,1,1
11,Bot,7,7,0,3,3
11,Bot,7,8,0,3,3
11,Bot,7,12,0,1,1
11,Bot,8,8,0,1,1
11,Bot,8,9,0,1,1
11,Bot,9,9,0,0,0
11,Bot,9,10,0,1,1
11,Bot,10,10,0,1,1
11,Bot,11,11,0,1,1
11,Bot,11,12,0,1,1
11,Bot,11,13,0,1,1
11,Bot,12,12,0,1,1
11,Top,0,0,0,5,5
11,Top,0,1,0,2,2
11,Top,1,1,0,8,8
11,Top,1,2,0,9,9
11,Top,1,3,0,1,1
11,Top,1,4,0,1,1
11,Top,2,2,0,9,9
11,Top,2,3,0,2,2
11,Top,2,4,0,1,1
11,Top,2,5,0,1,1
11,Top,2,6,0,1,1
11,Top,2,7,0,1,1
11,Top,3,3,0,17,17
11,Top,3,4,0,6,6
11,Top,3,5,0,3,3
11,Top,3,6,0,2,2
11,Top,4,4,0,9,9
11,Top,4,5,0,5,5
11,Top,4,6,0,2,2
11,Top,4,7,0,1,1
11,Top,4,8,0,1,1
11,Top,5,5,0,7,7
11,Top,5,6,0,1,1
11,Top,5,7,0,3,3
11,Top,6,6,0,4,4
11,Top,6,7,0,1,1
11,Top,6,8,0,1,1
11,Top,6,12,0,1,1
11,Top,7,7,0,3,3
11,Top,7,8,0,2,2
11,Top,7,10,0,0,0
11,Top,7,12,0,1,1
11,Top,8,8,0,1,1
11,Top,8,9,0,1,1
11,Top,9,9,0,0,0
11,Top,9,10,0,1,1
11,Top,9,13,0,1,1
11,Top,10,10,0,1,1
11,Top,11,11,0,1,1
11,Top,11,12,0,1,1
11,Top,12,12,0,1,1
12,Bot,0,0,0,2,2
12,Bot,0,1,0,1,1
12,Bot,0,2,0,2,2
12,Bot,1,1,0,7,7
12,Bot,1,2,0,2,2
12,Bot,2,2,0,6,6
12,Bot,2,3,0,1,1
12,Bot,2,4,0,2,2
12,Bot,3,3,0,10,10
12,Bot,3,4,0,2,2
12,Bot,3,5,0,5,5
12,Bot,3,7,0,1,1
12,Bot,4,4,0,5,5
12,Bot,4,5,0,2,2
12,Bot,4,6,0,1,1
12,Bot,4,7,0,1,1
12,Bot,5,5,0,4,4
12,Bot,5,6,0,1,1
12,Bot,5,8,0,1,1
12,Bot,6,6,0,2,2
12,Bot,6,7,0,1,1
12,Bot,6,8,0,1,1
12,Bot,7,7,0,2,2
12,Bot,7,8,0,1,1
12,Bot,8,8,0,0,0
12,Bot,8,12,0,1,1
12,Bot,9,9,0,0,0
12,Bot,10,10,0,1,1
12,Bot,11,11,0,0,0
12,Bot,12,12,0,1,1
12,Bot,12,16,0,1,1
12,Top,0,0,0,2,2
12,Top,0,1,0,1,1
12,Top,0,2,0,2,2
12,Top,1,1,0,7,7
12,Top,1,2,0,2,2
12,Top,2,2,0,6,6
12,Top,2,3,0,2,2
12,Top,2,4,0,2,2
12,Top,3,3,0,9,9
12,Top,3,4,0,4,4
12,Top,3,5,0,4,4
12,Top,3,7,0,1,1
12,Top,4,4,0,4,4
12,Top,4,5,0,3,3
12,Top,4,6,0,1,1
12,Top,4,7,0,1,1
12,Top,5,5,0,3,3
12,Top,5,6,0,1,1
12,Top,5,8,0,1,1
12,Top,6,6,0,2,2
12,Top,6,7,0,1,1
12,Top,6,8,0,1,1
12,Top,7,7,0,2,2
12,Top,7,8,0,1,1
12,Top,8,8,0,0,0
12,Top,8,9,0,0,0
12,Top,8,12,0,1,1
12,Top,9,9,0,0,0
12,Top,9,10,0,0,0
12,Top,10,10,0,1,1
12,Top,11,11,0,0,0
12,Top,11,16,0,1,1
12,Top,12,12,0,1,1
13,Bot,0,0,0,0,0
13,Bot,0,1,0,1,1
13,Bot,0,3,0,1,1
13,Bot,1,1,0,3,3
13,Bot,1,2,0,3,3
13,Bot,2,2,0,4,4
13,Bot,2,3,0,2,2
13,Bot,2,4,0,1,1
13,Bot,3,3,0,9,9
13,Bot,3,4,0,1,1
13,Bot,4,4,0,2,2
13,Bot,4,5,0,2,2
13,Bot,5,5,0,2,2
13,Bot,5,6,0,1,1
13,Bot,6,6,0,2,2
13,Bot,6,7,0,2,2
13,Bot,7,7,0,2,2
13,Bot,9,9,0,0,0
13,Bot,10,10,0,0,0
13,Bot,10,12,0,1,1
13,Bot,11,11,0,0,0
13,Bot,13,13,0,1,1
13,Top,0,0,0,0,0
13,Top,0,1,0,1,1
13,Top,0,3,0,1,1
13,Top,1,1,0,4,4
13,Top,1,2,0,2,2
13,Top,1,3,0,1,1
13,Top,2,2,0,4,4
13,Top,2,3,0,1,1
13,Top,2,4,0,1,1
13,Top,3,3,0,9,9
13,Top,3,4,0,1,1
13,Top,4,4,0,2,2
13,Top,4,5,0,2,2
13,Top,4,7,0,1,1
13,Top,5,5,0,2,2
13,Top,5,6,0,2,2
13,Top,6,6,0,2,2
13,Top,7,7,0,2,2
13,Top,8,9,0,0,0
13,Top,9,9,0,0,0
13,Top,10,10,0,0,0
13,Top,10,12,0,1,1
13,Top,11,11,0,0,0
13,Top,12,13,0,1,1
14,Bot,1,1,0,0,0
14,Bot,1,2,0,1,1
14,Bot,1,3,0,1,1
14,Bot,1,7,0,1,1
14,Bot,2,2,0,3,3
14,Bot,2,3,0,1,1
14,Bot,3,3,0,4,4
14,Bot,3,4,0,1,1
14,Bot,3,5,0,1,1
14,Bot,3,6,0,1,1
14,Bot,3,7,0,1,1
14,Bot,4,4,0,1,1
14,Bot,4,5,0,2,2
14,Bot,5,5,0,2,2
14,Bot,6,6,0,2,2
14,Bot,7,7,0,1,1
14,Bot,7,8,0,1,1
14,Bot,9,9,0,0,0
14,Bot,10,10,0,0,0
14,Bot,11,11,0,0,0
14,Bot,14,15,0,1,1
14,Top,0,1,0,0,0
14,Top,1,1,0,0,0
14,Top,1,2,0,1,1
14,Top,1,3,0,1,1
14,Top,1,7,0,1,1
14,Top,2,2,0,3,3
14,Top,2,3,0,1,1
14,Top,3,3,0,4,4
14,Top,3,4,0,1,1
14,Top,3,5,0,2,2
14,Top,3,6,0,1,1
14,Top,3,7,0,1,1
14,Top,4,4,0,1,1
14,Top,4,5,0,1,1
14,Top,5,5,0,2,2
14,Top,6,6,0,2,2
14,Top,7,7,0,1,1
14,Top,7,8,0,1,1
14,Top,9,9,0,0,0
14,Top,10,10,0,0,0
14,Top,11,11,0,0,0
14,Top,13,15,0,1,1
15,Bot,1,1,0,0,0
15,Bot,2,2,0,2,2
15,Bot,2,3,0,1,1
15,Bot,3,3,0,2,2
15,Bot,3,4,0,1,1
15,Bot,4,4,0,1,1
15,Bot,5,5,0,1,1
15,Bot,5,6,0,1,1
15,Bot,6,6,0,0,0
15,Bot,6,7,0,2,2
15,Bot,7,7,0,0,0
15,Bot,7,10,0,1,1
15,Bot,8,8,0,1,1
15,Bot,10,10,0,0,0
15,Top,1,1,0,0,0
15,Top,2,2,0,2,2
15,Top,2,3,0,1,1
15,Top,3,3,0,2,2
15,Top,3,4,0,1,1
15,Top,3,6,0,1,1
15,Top,4,4,0,1,1
15,Top,4,6,0,0,0
15,Top,5,5,0,1,1
15,Top,5,8,0,1,1
15,Top,6,7,0,2,2
15,Top,7,10,0,1,1
15,Top,10,10,0,0,0
16,Bot,1,1,0,0,0
16,Bot,2,2,0,2,2
16,Bot,3,3,0,0,0
16,Bot,3,4,0,1,1
16,Bot,3,6,0,1,1
16,Bot,4,4,0,0,0
16,Bot,5,8,0,1,1
16,Bot,6,9,0,1,1
16,Bot,8,10,0,1,1
16,Top,1,1,0,0,0
16,Top,1,2,0,0,0
16,Top,2,2,0,2,2
16,Top,3,3,0,0,0
16,Top,3,4,0,1,1
16,Top,3,6,0,1,1
16,Top,4,4,0,0,0
16,Top,4,9,0,1,1
16,Top,5,8,0,1,1
16,Top,8,10,0,1,1
17,Bot,2,2,0,2,2
17,Bot,3,3,0,0,0
17,Top,2,2,0,2,2
17,Top,3,3,0,0,0
18,Bot,2,2,0,0,0
18,Bot,2,3,0,1,1
18,Bot,2,5,0,1,1
18,Top,2,2,0,1,1
18,Top,2,5,0,1,1
19,Bot,2,2,0,0,0
19,Top,2,2,0,0,0
